Rk,Player,Pos,Age,Tm,G,GS,MP,FG,FGA,FG%,3P,3PA,3P%,2P,2PA,2P%,eFG%,FT,FTA,FT%,ORB,DRB,TRB,AST,STL,BLK,TOV,PF,PTS
1,Steven Adams\adamsst01,C,26,OKC,58,58,1564,262,443,.591,1,3,.333,261,440,.593,.593,108,183,.590,196,347,543,141,50,65,86,111,633
2,Bam Adebayo\adebaba01,PF,22,MIA,65,65,2235,408,719,.567,1,13,.077,407,706,.576,.568,236,342,.690,165,518,683,333,78,85,185,164,1053
3,LaMarcus Aldridge\aldrila01,C,34,SAS,53,53,1754,391,793,.493,61,157,.389,330,636,.519,.532,158,191,.827,103,289,392,129,36,87,74,128,1001
4,Nickeil Alexander-Walker\alexani01,SG,21,NOP,41,0,501,77,227,.339,40,117,.342,37,110,.336,.427,17,28,.607,8,72,80,74,11,7,40,46,211
5,Grayson Allen\allengr01,SG,24,MEM,31,0,520,81,180,.450,34,92,.370,47,88,.534,.544,30,36,.833,5,63,68,43,8,1,25,38,226
6,Jarrett Allen\allenja01,C,21,BRK,65,59,1674,274,422,.649,0,5,.000,274,417,.657,.649,147,237,.620,197,413,610,88,37,85,72,148,695
7,Kadeem Allen\allenka01,SG,27,NYK,10,0,117,19,44,.432,5,16,.313,14,28,.500,.489,7,11,.636,2,7,9,21,5,2,8,7,50
8,Al-Farouq Aminu\aminual01,PF,29,ORL,18,2,380,25,86,.291,9,36,.250,16,50,.320,.343,19,29,.655,24,63,87,21,18,8,17,27,78
9,Justin Anderson\anderju01,SF,26,BRK,4,0,27,1,8,.125,0,5,.000,1,3,.333,.125,1,2,.500,1,4,5,4,0,2,1,2,3
10,Kyle Anderson\anderky01,PF,26,MEM,60,21,1158,139,285,.488,17,65,.262,122,220,.555,.518,44,68,.647,54,205,259,133,47,31,56,90,339
11,Ryan Anderson\anderry01,PF,31,HOU,2,0,14,2,7,.286,1,5,.200,1,2,.500,.357,0,0,,0,7,7,2,1,0,1,1,5
12,Giannis Antetokounmpo\antetgi01,PF,25,MIL,58,58,1795,637,1159,.550,84,274,.307,553,885,.625,.586,368,582,.632,131,667,798,336,60,59,211,178,1726
13,Kostas Antetokounmpo\antetko01,PF,22,LAL,3,0,5,0,0,,0,0,,0,0,,,0,0,,0,1,1,1,0,0,0,0,0
14,Thanasis Antetokounmpo\antetth01,SF,27,MIL,18,2,93,19,36,.528,0,7,.000,19,29,.655,.528,7,15,.467,11,8,19,9,6,2,11,13,45
15,Carmelo Anthony\anthoca01,PF,35,POR,51,51,1660,296,689,.430,74,198,.374,222,491,.452,.483,118,139,.849,62,258,320,79,42,23,92,147,784
16,OG Anunoby\anunoog01,SF,22,TOR,63,62,1897,267,527,.507,82,215,.381,185,312,.593,.584,59,86,.686,74,267,341,99,88,42,75,155,675
17,Ryan Arcidiacono\arcidry01,PG,25,CHI,58,4,930,90,220,.409,54,138,.391,36,82,.439,.532,27,38,.711,20,90,110,96,27,3,37,96,261
18,Trevor Ariza\arizatr01,SF,34,TOT,53,21,1493,142,324,.438,77,207,.372,65,117,.556,.557,62,74,.838,34,212,246,91,69,15,56,111,423
18,Trevor Ariza\arizatr01,SF,34,SAC,32,0,791,64,165,.388,43,122,.352,21,43,.488,.518,21,27,.778,21,125,146,50,35,7,28,63,192
18,Trevor Ariza\arizatr01,SF,34,POR,21,21,702,78,159,.491,34,85,.400,44,74,.595,.597,41,47,.872,13,87,100,41,34,8,28,48,231
19,D.J. Augustin\augusdj01,PG,32,ORL,50,7,1242,161,406,.397,61,177,.345,100,229,.437,.472,139,157,.885,18,92,110,226,30,1,71,54,522
20,Deandre Ayton\aytonde01,C,21,PHO,31,26,1031,266,479,.555,2,6,.333,264,473,.558,.557,60,78,.769,126,246,372,60,22,53,72,99,594
21,Dwayne Bacon\bacondw01,SG,24,CHO,39,11,687,85,244,.348,19,67,.284,66,177,.373,.387,35,53,.660,15,85,100,52,23,2,37,52,224
22,Marvin Bagley III\baglema01,PF,20,SAC,13,6,334,78,167,.467,4,22,.182,74,145,.510,.479,25,31,.806,29,68,97,10,6,12,18,43,185
23,Lonzo Ball\balllo01,PG,22,NOP,57,48,1844,261,641,.407,139,367,.379,122,274,.445,.516,38,69,.551,65,289,354,399,82,30,175,114,699
24,Mo Bamba\bambamo01,C,21,ORL,61,0,872,132,285,.463,37,107,.346,95,178,.534,.528,31,46,.674,99,202,301,42,23,85,42,115,332
25,J.J. Barea\bareajo01,PG,35,DAL,26,4,391,74,179,.413,29,76,.382,45,103,.437,.494,17,18,.944,10,38,48,99,4,2,35,25,194
26,Harrison Barnes\barneha02,PF,27,SAC,65,65,2267,330,716,.461,94,245,.384,236,471,.501,.527,197,246,.801,62,251,313,153,40,10,82,84,951
27,RJ Barrett\barrerj01,SG,19,NYK,56,55,1704,292,727,.402,63,197,.320,229,530,.432,.445,156,254,.614,50,229,279,143,55,17,124,122,803
28,Will Barton\bartowi01,SF,29,DEN,58,58,1916,332,738,.450,108,288,.375,224,450,.498,.523,102,133,.767,76,289,365,212,61,29,88,121,874
29,Keita Bates-Diop\bateske01,SF,24,TOT,39,0,665,89,208,.428,31,94,.330,58,114,.509,.502,49,69,.710,21,91,112,30,17,21,14,38,258
29,Keita Bates-Diop\bateske01,SF,24,MIN,37,0,646,87,206,.422,31,94,.330,56,112,.500,.498,46,65,.708,21,89,110,30,17,20,14,36,251
29,Keita Bates-Diop\bateske01,SF,24,DEN,2,0,19,2,2,1.000,0,0,,2,2,1.000,1.000,3,4,.750,0,2,2,0,0,1,0,2,7
30,Nicolas Batum\batumni01,SF,31,CHO,22,3,505,28,81,.346,14,49,.286,14,32,.438,.432,9,10,.900,25,75,100,66,17,8,22,41,79
31,Aron Baynes\baynear01,C,33,PHO,42,28,934,183,381,.480,59,168,.351,124,213,.582,.558,56,75,.747,71,166,237,67,10,23,50,141,481
32,Kent Bazemore\bazemke01,SF-SG,30,TOT,65,21,1627,188,503,.374,79,231,.342,109,272,.401,.452,110,143,.769,26,262,288,90,72,39,87,185,565
32,Kent Bazemore\bazemke01,SF,30,POR,43,21,1111,113,326,.347,56,171,.327,57,155,.368,.433,58,72,.806,13,159,172,61,45,31,60,121,340
32,Kent Bazemore\bazemke01,SG,30,SAC,22,0,516,75,177,.424,23,60,.383,52,117,.444,.489,52,71,.732,13,103,116,29,27,8,27,64,225
33,Darius Bazley\bazleda01,PF,19,OKC,53,8,909,88,230,.383,30,100,.300,58,130,.446,.448,32,47,.681,21,175,196,29,20,35,40,45,238
34,Bradley Beal\bealbr01,SG,26,WAS,57,57,2053,593,1303,.455,170,481,.353,423,822,.515,.520,385,457,.842,52,190,242,347,71,23,194,126,1741
35,Malik Beasley\beaslma01,SG,23,TOT,55,14,1209,227,534,.425,107,276,.388,120,258,.465,.525,54,66,.818,18,130,148,75,40,8,57,77,615
35,Malik Beasley\beaslma01,SG,23,DEN,41,0,746,117,301,.389,58,161,.360,59,140,.421,.485,33,38,.868,9,68,77,48,31,6,36,50,325
35,Malik Beasley\beaslma01,SG,23,MIN,14,14,463,110,233,.472,49,115,.426,61,118,.517,.577,21,28,.750,9,62,71,27,9,2,21,27,290
36,Marco Belinelli\belinma01,SG,33,SAS,53,0,794,107,275,.389,57,157,.363,50,118,.424,.493,39,48,.813,4,87,91,65,11,1,16,41,310
37,Jordan Bell\belljo01,C-PF,25,TOT,29,0,256,35,67,.522,4,12,.333,31,55,.564,.552,19,31,.613,30,51,81,16,3,10,21,19,93
37,Jordan Bell\belljo01,C,25,MIN,27,0,235,32,60,.533,2,9,.222,30,51,.588,.550,17,29,.586,28,50,78,14,2,10,18,17,83
37,Jordan Bell\belljo01,PF,25,MEM,2,0,21,3,7,.429,2,3,.667,1,4,.250,.571,2,2,1.000,2,1,3,2,1,0,3,2,10
38,DeAndre' Bembry\bembrde01,SG,25,ATL,43,4,915,104,228,.456,15,65,.231,89,163,.546,.489,26,48,.542,34,118,152,81,55,19,60,84,249
39,Dragan Bender\bendedr01,SF,22,TOT,16,3,286,41,92,.446,15,43,.349,26,49,.531,.527,10,14,.714,16,57,73,28,4,9,21,42,107
39,Dragan Bender\bendedr01,SF,22,MIL,7,0,91,10,21,.476,4,9,.444,6,12,.500,.571,2,3,.667,0,20,20,9,0,5,5,16,26
39,Dragan Bender\bendedr01,SF,22,GSW,9,3,195,31,71,.437,11,34,.324,20,37,.541,.514,8,11,.727,16,37,53,19,4,4,16,26,81
40,Dāvis Bertāns\bertada01,PF,27,WAS,54,4,1583,265,610,.434,200,472,.424,65,138,.471,.598,104,122,.852,35,210,245,92,37,33,59,139,834
41,Patrick Beverley\beverpa01,PG,31,LAC,49,48,1315,142,332,.428,77,201,.383,65,131,.496,.544,31,46,.674,56,204,260,180,53,25,66,154,392
42,Khem Birch\birchkh01,C,27,ORL,41,24,794,59,121,.488,0,1,.000,59,120,.492,.488,47,73,.644,72,112,184,40,17,23,24,76,165
43,Goga Bitadze\bitadgo01,C,20,IND,49,2,410,61,129,.473,6,36,.167,55,93,.591,.496,24,33,.727,22,74,96,21,6,32,25,57,152
44,Bismack Biyombo\biyombi01,C,27,CHO,53,29,1029,151,278,.543,0,0,,151,278,.543,.543,91,151,.603,120,188,308,50,10,49,48,116,393
45,Nemanja Bjelica\bjeline01,PF,31,SAC,65,62,1852,292,612,.477,126,298,.423,166,314,.529,.580,61,74,.824,107,310,417,180,56,34,93,199,771
46,Eric Bledsoe\bledser01,PG,30,MIL,56,56,1524,319,662,.482,70,201,.348,249,461,.540,.535,157,193,.813,41,218,259,302,53,25,140,120,865
47,Bogdan Bogdanović\bogdabo01,SG,27,SAC,54,21,1542,285,654,.436,143,391,.366,142,263,.540,.545,78,107,.729,17,156,173,171,56,14,90,117,791
48,Bojan Bogdanović\bogdabo02,SF,30,UTA,63,63,2083,418,935,.447,189,457,.414,229,478,.479,.548,250,277,.903,39,220,259,131,34,7,159,110,1275
49,Jonah Bolden\boldejo01,PF,24,TOT,7,0,47,4,11,.364,0,4,.000,4,7,.571,.364,2,4,.500,3,6,9,0,3,2,2,10,10
49,Jonah Bolden\boldejo01,PF,24,PHI,4,0,14,2,3,.667,0,1,.000,2,2,1.000,.667,0,2,.000,0,1,1,0,1,0,2,4,4
49,Jonah Bolden\boldejo01,PF,24,PHO,3,0,33,2,8,.250,0,3,.000,2,5,.400,.250,2,2,1.000,3,5,8,0,2,2,0,6,6
50,Marques Bolden\boldema01,C,21,CLE,1,0,3,0,0,,0,0,,0,0,,,0,0,,0,2,2,0,1,0,0,1,0
51,Jordan Bone\bonejo01,PG,22,DET,10,0,53,5,20,.250,2,10,.200,3,10,.300,.300,0,0,,0,4,4,8,1,0,2,6,12
52,Isaac Bonga\bongais01,SF,20,WAS,59,42,1048,98,190,.516,22,56,.393,76,134,.567,.574,57,69,.826,62,125,187,62,38,21,43,139,275
53,Devin Booker\bookede01,SG,23,PHO,63,63,2277,552,1139,.485,128,357,.359,424,782,.542,.541,414,451,.918,27,236,263,412,46,16,249,192,1646
54,Chris Boucher\bouchch01,PF,27,TOR,55,0,724,119,260,.458,28,99,.283,91,161,.565,.512,82,103,.796,94,148,242,23,20,53,23,104,348
55,Brian Bowen\bowenbr02,SG,21,IND,5,1,29,2,9,.222,0,2,.000,2,7,.286,.222,0,0,,1,6,7,0,0,1,1,2,4
56,Ky Bowman\bowmaky01,PG,22,GSW,45,12,1015,134,321,.417,33,107,.308,101,214,.472,.469,34,41,.829,24,97,121,131,44,10,70,102,335
57,Avery Bradley\bradlav01,SG,29,LAL,49,44,1186,170,383,.444,63,173,.364,107,210,.510,.526,20,24,.833,18,97,115,63,43,5,47,110,423
58,Tony Bradley\bradlto01,C,22,UTA,51,2,550,105,157,.669,1,1,1.000,104,156,.667,.672,26,40,.650,93,128,221,17,13,26,24,100,237
59,Jarrell Brantley\brantja01,PF,23,UTA,5,0,13,0,0,,0,0,,0,0,,,0,0,,0,5,5,1,0,2,2,2,0
60,Ignas Brazdeikis\brazdig01,SF,21,NYK,9,0,53,6,22,.273,1,9,.111,5,13,.385,.295,4,5,.800,2,3,5,4,0,1,2,3,17
61,Mikal Bridges\bridgmi01,SF,23,PHO,66,25,1806,214,415,.516,57,164,.348,157,251,.625,.584,93,111,.838,59,203,262,118,94,39,66,144,578
62,Miles Bridges\bridgmi02,SF,21,CHO,65,64,1995,319,753,.424,99,300,.330,220,453,.486,.489,106,131,.809,88,274,362,114,40,48,95,132,843
63,Oshae Brissett\brissos01,SF,21,TOR,19,0,135,13,36,.361,3,15,.200,10,21,.476,.403,8,10,.800,9,17,26,7,4,1,7,18,37
64,Ryan Broekhoff\broekry01,SG,29,DAL,17,1,180,22,59,.373,20,51,.392,2,8,.250,.542,7,8,.875,5,38,43,11,5,4,6,15,71
65,Malcolm Brogdon\brogdma01,PG,27,IND,48,48,1472,289,659,.439,61,195,.313,228,464,.491,.485,145,162,.895,40,186,226,343,33,8,115,88,784
66,Dillon Brooks\brookdi01,SG,24,MEM,66,66,1887,378,941,.402,134,367,.365,244,574,.425,.473,145,180,.806,63,154,217,132,58,26,110,250,1035
67,Bruce Brown\brownbr01,SG,23,DET,58,43,1634,198,447,.443,33,96,.344,165,351,.470,.480,88,119,.739,61,213,274,230,63,29,100,162,517
68,Charlie Brown\brownch02,SG,22,ATL,10,0,40,6,19,.316,3,9,.333,3,10,.300,.395,5,5,1.000,2,2,4,2,2,2,3,3,20
69,Jaylen Brown\brownja02,SF,23,BOS,51,51,1736,384,787,.488,110,291,.378,274,496,.552,.558,166,225,.738,55,267,322,110,57,16,117,156,1044
70,Moses Brown\brownmo01,C,20,POR,9,0,33,4,10,.400,0,0,,4,10,.400,.400,3,8,.375,3,11,14,1,1,1,3,7,11
71,Sterling Brown\brownst02,SF,24,MIL,46,1,688,81,222,.365,36,117,.308,45,105,.429,.446,28,36,.778,29,142,171,47,25,7,37,47,226
72,Troy Brown Jr.\browntr01,SG,20,WAS,62,15,1546,235,517,.455,50,147,.340,185,370,.500,.503,89,117,.761,65,261,326,143,77,6,65,114,609
73,Jalen Brunson\brunsja01,PG,23,DAL,57,16,1022,181,388,.466,43,120,.358,138,268,.515,.522,61,75,.813,22,112,134,188,22,4,66,74,466
74,Thomas Bryant\bryanth01,C,22,WAS,39,29,934,188,319,.589,23,58,.397,165,261,.632,.625,71,97,.732,76,191,267,74,16,33,48,87,470
75,Reggie Bullock\bullore01,SG,28,NYK,29,19,684,90,224,.402,37,111,.333,53,113,.469,.484,17,21,.810,13,55,68,42,25,3,19,56,234
76,Trey Burke\burketr01,PG,27,TOT,26,0,359,70,143,.490,24,48,.500,46,95,.484,.573,14,20,.700,15,21,36,59,8,1,12,23,178
76,Trey Burke\burketr01,PG,27,PHI,25,0,329,59,127,.465,16,38,.421,43,89,.483,.528,13,18,.722,15,20,35,53,7,1,12,21,147
76,Trey Burke\burketr01,G,27,DAL,1,0,30,11,16,.688,8,10,.800,3,6,.500,.938,1,2,.500,0,1,1,6,1,0,0,2,31
77,Alec Burks\burksal01,SG,28,TOT,59,18,1612,283,701,.404,100,273,.366,183,428,.428,.475,225,251,.896,43,219,262,171,58,17,85,120,891
77,Alec Burks\burksal01,SG,28,GSW,48,18,1390,244,601,.406,84,224,.375,160,377,.424,.476,201,224,.897,37,189,226,151,50,17,76,107,773
77,Alec Burks\burksal01,SG,28,PHI,11,0,222,39,100,.390,16,49,.327,23,51,.451,.470,24,27,.889,6,30,36,20,8,0,9,13,118
78,Deonte Burton\burtode02,SG,26,OKC,34,0,284,39,105,.371,10,46,.217,29,59,.492,.419,6,12,.500,6,42,48,11,5,10,14,28,94
79,Jimmy Butler\butleji01,SF,30,MIA,54,54,1851,328,722,.454,29,117,.248,299,605,.494,.474,408,490,.833,98,261,359,331,92,29,118,74,1093
80,Bruno Caboclo\cabocbr01,SF,24,TOT,27,0,220,32,77,.416,4,28,.143,28,49,.571,.442,4,5,.800,22,31,53,12,12,16,9,25,72
80,Bruno Caboclo\cabocbr01,SF,24,MEM,22,0,192,28,69,.406,4,25,.160,24,44,.545,.435,2,3,.667,17,27,44,10,10,12,7,23,62
80,Bruno Caboclo\cabocbr01,SF,24,HOU,5,0,28,4,8,.500,0,3,.000,4,5,.800,.500,2,2,1.000,5,4,9,2,2,4,2,2,10
81,Kentavious Caldwell-Pope\caldwke01,SG,26,LAL,64,21,1633,222,474,.468,87,224,.388,135,250,.540,.560,76,98,.776,37,96,133,107,54,13,56,120,607
82,Vlatko Čančar\cancavl01,SF,22,DEN,14,0,45,6,15,.400,1,6,.167,5,9,.556,.433,4,4,1.000,5,5,10,3,1,1,3,7,17
83,Clint Capela\capelca01,C,25,HOU,39,39,1279,244,388,.629,0,0,,244,388,.629,.629,55,104,.529,168,369,537,48,33,72,63,102,543
84,DeMarre Carroll\carrode01,SF,33,TOT,21,0,231,21,54,.389,7,27,.259,14,27,.519,.454,24,36,.667,11,36,47,18,4,4,16,28,73
84,DeMarre Carroll\carrode01,SF,33,SAS,15,0,135,9,29,.310,3,13,.231,6,16,.375,.362,12,20,.600,7,24,31,11,2,2,10,20,33
84,DeMarre Carroll\carrode01,SF,33,HOU,6,0,96,12,25,.480,4,14,.286,8,11,.727,.560,12,16,.750,4,12,16,7,2,2,6,8,40
85,Jevon Carter\carteje01,PG,24,PHO,51,2,779,84,210,.400,47,121,.388,37,89,.416,.512,23,27,.852,25,75,100,66,39,13,31,77,238
86,Vince Carter\cartevi01,SF,43,ATL,60,0,876,107,304,.352,61,202,.302,46,102,.451,.452,23,29,.793,18,106,124,48,23,25,33,90,298
87,Wendell Carter Jr.\cartewe01,C,20,CHI,43,43,1256,183,343,.534,6,29,.207,177,314,.564,.542,112,152,.737,139,266,405,51,33,36,72,162,484
88,Michael Carter-Williams\cartemi01,SG,28,ORL,43,0,795,107,251,.426,21,71,.296,86,180,.478,.468,73,88,.830,45,96,141,104,46,20,49,84,308
89,Alex Caruso\carusal01,PG,25,LAL,59,1,1060,112,267,.419,38,109,.349,74,158,.468,.491,61,82,.744,15,101,116,104,61,17,46,86,323
90,Willie Cauley-Stein\caulewi01,C,26,TOT,54,39,1097,175,302,.579,0,1,.000,175,301,.581,.579,40,66,.606,84,231,315,70,49,61,40,121,390
90,Willie Cauley-Stein\caulewi01,C,26,GSW,41,37,940,144,257,.560,0,0,,144,257,.560,.560,35,57,.614,71,184,255,60,45,50,35,102,323
90,Willie Cauley-Stein\caulewi01,C,26,DAL,13,2,157,31,45,.689,0,1,.000,31,44,.705,.689,5,9,.556,13,47,60,10,4,11,5,19,67
91,Tyson Chandler\chandty01,C,37,HOU,26,5,219,14,18,.778,0,0,,14,18,.778,.778,6,13,.462,25,41,66,6,6,8,8,32,34
92,Wilson Chandler\chandwi01,SF,32,BRK,35,3,734,74,183,.404,37,121,.306,37,62,.597,.505,20,23,.870,11,134,145,39,16,12,34,79,205
93,Joe Chealey\chealjo01,PG,24,CHO,4,0,33,0,7,.000,0,4,.000,0,3,.000,.000,2,2,1.000,0,0,0,1,4,0,2,2,2
94,Zylan Cheatham\cheatzy01,SF,24,NOP,3,0,31,2,5,.400,0,1,.000,2,4,.500,.400,0,0,,1,5,6,2,0,1,3,5,4
95,Chris Chiozza\chiozch01,PG,24,TOT,22,1,266,33,85,.388,18,46,.391,15,39,.385,.494,2,2,1.000,7,29,36,51,15,2,17,25,86
95,Chris Chiozza\chiozch01,PG,24,WAS,10,0,123,10,34,.294,7,16,.438,3,18,.167,.397,0,0,,0,15,15,28,10,2,9,12,27
95,Chris Chiozza\chiozch01,PG,24,BRK,12,1,143,23,51,.451,11,30,.367,12,21,.571,.559,2,2,1.000,7,14,21,23,5,0,8,13,59
96,Marquese Chriss\chrisma01,PF,22,GSW,59,21,1196,210,385,.545,8,39,.205,202,346,.584,.556,120,156,.769,114,251,365,114,39,62,78,122,548
97,Gary Clark\clarkga01,PF,25,TOT,36,1,431,39,103,.379,29,88,.330,10,15,.667,.519,8,9,.889,27,58,85,15,5,14,6,31,115
97,Gary Clark\clarkga01,PF,25,HOU,18,0,212,23,59,.390,18,51,.353,5,8,.625,.542,6,7,.857,11,29,40,12,2,7,2,21,70
97,Gary Clark\clarkga01,PF,25,ORL,18,1,219,16,44,.364,11,37,.297,5,7,.714,.489,2,2,1.000,16,29,45,3,3,7,4,10,45
98,Brandon Clarke\clarkbr01,PF,23,MEM,51,3,1120,261,416,.627,21,52,.404,240,364,.659,.653,80,101,.792,80,219,299,74,27,44,46,83,623
99,Jordan Clarkson\clarkjo01,SG,27,TOT,64,0,1559,358,770,.465,131,361,.363,227,409,.555,.550,128,152,.842,47,125,172,127,45,15,84,93,975
99,Jordan Clarkson\clarkjo01,SG,27,CLE,29,0,666,144,326,.442,59,159,.371,85,167,.509,.532,76,86,.884,21,48,69,70,17,8,39,33,423
99,Jordan Clarkson\clarkjo01,SG,27,UTA,35,0,893,214,444,.482,72,202,.356,142,242,.587,.563,52,66,.788,26,77,103,57,28,7,45,60,552
100,Nicolas Claxton\claxtni01,PF,20,BRK,15,0,187,27,48,.563,1,7,.143,26,41,.634,.573,11,21,.524,19,25,44,16,1,8,9,14,66
101,Chris Clemons\clemoch01,SG,22,HOU,29,0,251,51,126,.405,33,94,.351,18,32,.563,.536,6,7,.857,3,20,23,22,6,5,17,20,141
102,Antonius Cleveland\clevean01,SG,25,DAL,7,0,22,2,6,.333,0,1,.000,2,5,.400,.333,1,2,.500,0,3,3,0,1,1,1,2,5
103,Amir Coffey\coffeam01,SG,22,LAC,14,0,103,14,34,.412,2,8,.250,12,26,.462,.441,1,3,.333,4,10,14,9,1,1,3,12,31
104,John Collins\collijo01,PF,22,ATL,41,41,1363,353,605,.583,59,147,.401,294,458,.642,.632,120,150,.800,116,300,416,60,31,66,75,138,885
105,Zach Collins\colliza01,PF,22,POR,4,4,123,12,28,.429,4,10,.400,8,18,.444,.500,6,6,1.000,7,14,21,9,1,2,6,17,34
106,Mike Conley\conlemi01,PG,32,UTA,42,36,1205,204,502,.406,82,220,.373,122,282,.433,.488,97,121,.802,28,106,134,182,32,5,78,94,587
107,Pat Connaughton\connapa01,SG,27,MIL,61,1,1119,119,261,.456,44,137,.321,75,124,.605,.540,27,36,.750,56,203,259,95,20,30,47,60,309
108,Quinn Cook\cookqu01,PG,26,LAL,38,0,409,76,173,.439,25,66,.379,51,107,.477,.512,6,9,.667,7,33,40,40,11,1,25,23,183
109,Tyler Cook\cookty01,PF,22,CLE,11,0,35,7,10,.700,0,0,,7,10,.700,.700,5,6,.833,4,6,10,1,1,0,1,4,19
110,Robert Covington\covinro01,PF,29,TOT,63,61,1909,284,662,.429,149,433,.344,135,229,.590,.542,90,112,.804,56,352,408,77,97,84,94,199,807
110,Robert Covington\covinro01,PF,29,MIN,48,47,1411,216,496,.435,108,312,.346,108,184,.587,.544,75,94,.798,36,251,287,56,80,45,73,148,615
110,Robert Covington\covinro01,PF,29,HOU,15,14,498,68,166,.410,41,121,.339,27,45,.600,.533,15,18,.833,20,101,121,21,17,39,21,51,192
111,Allen Crabbe\crabbal01,SG,27,TOT,37,1,653,63,177,.356,36,119,.303,27,58,.466,.458,10,14,.714,11,66,77,33,15,4,17,47,172
111,Allen Crabbe\crabbal01,SG,27,ATL,28,1,522,52,143,.364,30,93,.323,22,50,.440,.469,9,12,.750,10,55,65,28,15,4,12,36,143
111,Allen Crabbe\crabbal01,SG,27,MIN,9,0,131,11,34,.324,6,26,.231,5,8,.625,.412,1,2,.500,1,11,12,5,0,0,5,11,29
112,Torrey Craig\craigto01,SF,29,DEN,50,19,869,96,208,.462,36,109,.330,60,99,.606,.548,20,31,.645,48,108,156,34,18,32,22,112,248
113,Jae Crowder\crowdja01,SF,29,TOT,58,46,1695,197,513,.384,113,355,.318,84,158,.532,.494,95,121,.785,48,305,353,151,67,21,62,126,602
113,Jae Crowder\crowdja01,SF,29,MEM,45,45,1322,147,399,.368,78,266,.293,69,133,.519,.466,75,95,.789,40,237,277,125,47,14,54,85,447
113,Jae Crowder\crowdja01,SF,29,MIA,13,1,373,50,114,.439,35,89,.393,15,25,.600,.592,20,26,.769,8,68,76,26,20,7,8,41,155
114,Jarrett Culver\culveja01,SG,20,MIN,63,35,1506,230,569,.404,66,221,.299,164,348,.471,.462,54,117,.462,70,142,212,110,57,38,81,125,580
115,Seth Curry\curryse01,SG,29,DAL,60,21,1471,266,536,.496,136,303,.449,130,233,.558,.623,77,94,.819,26,114,140,119,38,9,61,107,745
116,Stephen Curry\curryst01,PG,31,GSW,5,5,139,33,82,.402,12,49,.245,21,33,.636,.476,26,26,1.000,4,22,26,33,5,2,16,11,104
117,Troy Daniels\danietr01,SG,28,TOT,42,0,457,62,159,.390,40,113,.354,22,46,.478,.516,10,16,.625,12,34,46,14,8,3,9,30,174
117,Troy Daniels\danietr01,SG,28,LAL,41,0,456,62,158,.392,40,112,.357,22,46,.478,.519,10,16,.625,12,34,46,14,8,3,9,30,174
117,Troy Daniels\danietr01,SG,28,DEN,1,0,1,0,1,.000,0,1,.000,0,0,,.000,0,0,,0,0,0,0,0,0,0,0,0
118,Anthony Davis\davisan02,PF,26,LAL,56,56,1925,516,1013,.509,67,199,.337,449,814,.552,.542,402,474,.848,126,399,525,176,82,134,139,142,1501
119,Ed Davis\davised01,C,30,UTA,25,0,268,14,34,.412,0,0,,14,34,.412,.412,5,11,.455,29,66,95,8,10,9,13,55,33
120,Terence Davis\daviste02,SG,22,TOR,64,2,1087,181,391,.463,88,222,.396,93,169,.550,.575,45,52,.865,46,171,217,107,32,12,65,104,495
121,Dewayne Dedmon\dedmode01,C,30,TOT,44,18,774,102,255,.400,22,107,.206,80,148,.541,.443,30,36,.833,60,189,249,22,25,41,57,133,256
121,Dewayne Dedmon\dedmode01,C,30,SAC,34,10,541,69,171,.404,14,71,.197,55,100,.550,.444,23,28,.821,46,121,167,15,15,26,47,93,175
121,Dewayne Dedmon\dedmode01,C,30,ATL,10,8,233,33,84,.393,8,36,.222,25,48,.521,.440,7,8,.875,14,68,82,7,10,15,10,40,81
122,Matthew Dellavedova\dellama01,PG,29,CLE,57,4,821,62,175,.354,21,91,.231,41,84,.488,.414,32,37,.865,18,57,75,180,20,2,59,78,177
123,DeMar DeRozan\derozde01,SF,30,SAS,62,62,2129,513,969,.529,8,30,.267,505,939,.538,.534,345,410,.841,40,309,349,350,62,14,151,168,1379
124,Cheick Diallo\diallch01,C,23,PHO,44,2,467,89,137,.650,1,2,.500,88,135,.652,.653,32,37,.865,28,99,127,22,10,12,30,54,211
125,Hamidou Diallo\diallha01,SF,21,OKC,38,3,699,99,219,.452,7,35,.200,92,184,.500,.468,28,45,.622,29,93,122,22,28,8,37,82,233
126,Gorgui Dieng\dienggo01,C,30,TOT,58,17,1012,158,343,.461,51,142,.359,107,201,.532,.535,61,83,.735,87,249,336,71,48,56,55,112,428
126,Gorgui Dieng\dienggo01,C,30,MIN,46,17,778,124,277,.448,46,120,.383,78,157,.497,.531,47,59,.797,73,183,256,58,37,42,44,89,341
126,Gorgui Dieng\dienggo01,C,30,MEM,12,0,234,34,66,.515,5,22,.227,29,44,.659,.553,14,24,.583,14,66,80,13,11,14,11,23,87
127,Spencer Dinwiddie\dinwisp01,SG,26,BRK,64,49,1994,424,1021,.415,123,400,.308,301,621,.485,.476,347,446,.778,32,189,221,432,40,21,174,180,1318
128,Donte DiVincenzo\divindo01,SG,23,MIL,60,23,1388,213,460,.463,78,226,.345,135,234,.577,.548,60,78,.769,60,235,295,139,80,18,74,101,564
129,Luka Dončić\doncilu01,PG,20,DAL,55,55,1841,523,1138,.460,157,500,.314,366,638,.574,.529,374,500,.748,71,444,515,480,60,11,235,140,1577
130,Luguentz Dort\dortlu01,SG,20,OKC,29,21,637,65,157,.414,22,73,.301,43,84,.512,.484,28,36,.778,15,39,54,21,23,2,15,78,180
131,Damyean Dotson\dotsoda01,SG,25,NYK,48,0,836,120,290,.414,59,163,.362,61,127,.480,.516,22,33,.667,10,81,91,57,23,4,21,44,321
132,Sekou Doumbouya\doumbse01,SF,19,DET,38,19,754,92,236,.390,28,98,.286,64,138,.464,.449,31,46,.674,20,98,118,19,20,8,35,80,243
133,PJ Dozier\doziepj01,PG,23,DEN,21,0,234,36,91,.396,7,28,.250,29,63,.460,.434,7,11,.636,5,25,30,29,7,5,11,27,86
134,Goran Dragić\dragigo01,PG,33,MIA,54,1,1531,290,663,.437,118,313,.377,172,350,.491,.526,170,221,.769,26,140,166,273,31,8,133,105,868
135,Andre Drummond\drumman01,C,26,TOT,57,56,1879,418,784,.533,5,35,.143,413,749,.551,.536,169,294,.575,250,614,864,152,109,93,203,201,1010
135,Andre Drummond\drumman01,C,26,DET,49,48,1654,360,679,.530,1,21,.048,359,658,.546,.531,149,255,.584,226,549,775,138,97,82,174,176,870
135,Andre Drummond\drumman01,C,26,CLE,8,8,225,58,105,.552,4,14,.286,54,91,.593,.571,20,39,.513,24,65,89,14,12,11,29,25,140
136,Jared Dudley\dudleja01,SF,34,LAL,40,1,311,20,50,.400,16,34,.471,4,16,.250,.560,2,2,1.000,5,38,43,19,12,3,6,36,58
137,Kris Dunn\dunnkr01,PG,25,CHI,51,32,1269,152,342,.444,29,112,.259,123,230,.535,.487,40,54,.741,23,163,186,173,101,17,68,158,373
138,Carsen Edwards\edwarca01,SG,21,BOS,35,0,316,37,113,.327,21,68,.309,16,45,.356,.420,11,13,.846,6,37,43,22,10,3,15,33,106
139,Henry Ellenson\ellenhe01,PF,23,BRK,5,0,15,1,7,.143,0,4,.000,1,3,.333,.143,0,0,,2,4,6,1,0,0,0,1,2
140,Wayne Ellington\ellinwa01,SG,32,NYK,36,1,558,61,174,.351,50,143,.350,11,31,.355,.494,11,13,.846,4,61,65,44,13,4,18,41,183
141,Joel Embiid\embiijo01,C,25,PHI,44,44,1329,332,701,.474,56,161,.348,276,540,.511,.514,311,382,.814,122,398,520,137,38,58,135,151,1031
142,James Ennis\ennisja01,SF,29,TOT,62,11,1078,130,296,.439,48,140,.343,82,156,.526,.520,66,82,.805,61,141,202,56,30,20,44,111,374
142,James Ennis\ennisja01,SF,29,PHI,49,0,776,100,226,.442,37,106,.349,63,120,.525,.524,48,61,.787,48,102,150,41,23,14,31,85,285
142,James Ennis\ennisja01,SF,29,ORL,13,11,302,30,70,.429,11,34,.324,19,36,.528,.507,18,21,.857,13,39,52,15,7,6,13,26,89
143,Drew Eubanks\eubandr01,PF,22,SAS,15,3,132,22,29,.759,1,1,1.000,21,28,.750,.776,8,11,.727,8,27,35,5,2,6,10,21,53
144,Jacob Evans\evansja02,SG,22,TOT,29,1,418,45,134,.336,13,39,.333,32,95,.337,.384,25,29,.862,9,32,41,31,11,12,25,41,128
144,Jacob Evans\evansja02,SG,22,GSW,27,1,414,45,133,.338,13,38,.342,32,95,.337,.387,25,29,.862,9,32,41,31,11,12,25,41,128
144,Jacob Evans\evansja02,SG,22,MIN,2,0,4,0,1,.000,0,1,.000,0,0,,.000,0,0,,0,0,0,0,0,0,0,0,0
145,Dante Exum\exumda01,SG,24,TOT,35,1,485,56,119,.471,15,43,.349,41,76,.539,.534,32,43,.744,12,55,67,40,13,8,31,38,159
145,Dante Exum\exumda01,SG,24,UTA,11,0,83,10,23,.435,2,6,.333,8,17,.471,.478,2,2,1.000,3,9,12,7,1,2,10,8,24
145,Dante Exum\exumda01,SG,24,CLE,24,1,402,46,96,.479,13,37,.351,33,59,.559,.547,30,41,.732,9,46,55,33,12,6,21,30,135
146,Tacko Fall\fallta01,C,24,BOS,6,0,24,9,12,.750,0,0,,9,12,.750,.750,1,3,.333,0,11,11,0,0,2,3,5,19
147,Derrick Favors\favorde01,C,28,NOP,46,44,1118,190,308,.617,1,7,.143,189,301,.628,.619,36,62,.581,149,304,453,76,28,44,53,101,417
148,Cristiano Felício\feliccr01,PF,27,CHI,22,0,386,34,54,.630,0,2,.000,34,52,.654,.630,18,23,.783,55,47,102,16,10,2,18,34,86
149,Terrance Ferguson\fergute01,SF,21,OKC,50,37,1170,74,199,.372,46,155,.297,28,44,.636,.487,15,19,.789,23,50,73,45,26,16,30,144,209
150,Bruno Fernando\fernabr01,C,21,ATL,56,13,713,103,199,.518,5,37,.135,98,162,.605,.530,29,51,.569,67,131,198,49,18,17,42,107,240
151,Yogi Ferrell\ferreyo01,PG,26,SAC,44,0,484,67,169,.396,19,69,.275,48,100,.480,.453,32,37,.865,6,42,48,59,14,4,25,31,185
152,Dorian Finney-Smith\finnedo01,PF,26,DAL,65,62,1926,216,464,.466,101,271,.373,115,193,.596,.574,70,97,.722,128,228,356,102,44,37,66,160,603
153,Bryn Forbes\forbebr01,SG,26,SAS,63,62,1579,242,581,.417,148,381,.388,94,200,.470,.544,75,90,.833,12,114,126,108,33,0,57,113,707
154,Evan Fournier\fournev01,SG,27,ORL,62,62,1956,418,884,.473,168,412,.408,250,472,.530,.568,169,206,.820,17,141,158,198,70,15,121,148,1173
155,De'Aaron Fox\foxde01,PG,22,SAC,46,44,1464,346,725,.477,48,160,.300,298,565,.527,.510,219,311,.704,33,151,184,310,65,24,144,132,959
156,Melvin Frazier\frazime01,SG,23,ORL,16,0,55,6,17,.353,4,7,.571,2,10,.200,.471,2,4,.500,1,4,5,1,5,2,3,8,18
157,Michael Frazier\frazimi01,SG,25,HOU,8,0,66,4,11,.364,2,8,.250,2,3,.667,.455,4,6,.667,1,2,3,1,2,0,2,13,14
158,Tim Frazier\fraziti01,PG,29,DET,27,11,355,34,94,.362,10,30,.333,24,64,.375,.415,19,24,.792,9,24,33,93,14,4,36,42,97
159,Markelle Fultz\fultzma01,PG,21,ORL,65,59,1832,324,685,.473,30,118,.254,294,567,.519,.495,102,141,.723,36,179,215,340,84,10,133,130,780
160,Wenyen Gabriel\gabriwe01,PF,22,TOT,28,1,210,20,46,.435,6,20,.300,14,26,.538,.500,14,20,.700,18,28,46,8,10,6,16,35,60
160,Wenyen Gabriel\gabriwe01,PF,22,SAC,11,0,61,6,17,.353,1,8,.125,5,9,.556,.382,6,10,.600,4,6,10,3,3,2,5,7,19
160,Wenyen Gabriel\gabriwe01,PF,22,POR,17,1,149,14,29,.483,5,12,.417,9,17,.529,.569,8,10,.800,14,22,36,5,7,4,11,28,41
161,Daniel Gafford\gaffoda01,C,21,CHI,43,7,609,94,134,.701,0,0,,94,134,.701,.701,32,60,.533,52,54,106,21,13,56,29,98,220
162,Danilo Gallinari\gallida01,PF,31,OKC,55,55,1690,329,749,.439,165,403,.409,164,346,.474,.549,234,264,.886,32,270,302,113,40,4,70,66,1057
163,Langston Galloway\gallola01,SG,28,DET,66,6,1702,236,542,.435,132,331,.399,104,211,.493,.557,73,85,.859,33,116,149,101,48,11,40,96,677
164,Darius Garland\garlada01,PG,20,CLE,59,59,1824,280,699,.401,105,296,.355,175,403,.434,.476,63,72,.875,27,84,111,229,42,4,151,92,728
165,Marc Gasol\gasolma01,C,35,TOR,36,35,990,99,236,.419,51,127,.402,48,109,.440,.528,26,36,.722,29,199,228,124,28,33,43,101,275
166,Rudy Gay\gayru01,PF,33,SAS,61,5,1313,230,517,.445,61,190,.321,169,327,.517,.504,99,113,.876,57,273,330,102,26,29,79,89,620
167,Paul George\georgpa01,SF,29,LAC,43,43,1256,302,691,.437,139,344,.404,163,347,.470,.538,167,191,.874,22,224,246,165,59,20,118,106,910
168,Taj Gibson\gibsota01,C,34,NYK,62,56,1025,167,286,.584,4,14,.286,163,272,.599,.591,41,56,.732,111,156,267,52,27,30,47,122,379
169,Harry Giles\gilesha01,PF,21,SAC,39,17,583,117,209,.560,0,0,,117,209,.560,.560,33,43,.767,33,127,160,50,21,14,35,100,267
170,Shai Gilgeous-Alexander\gilgesh01,SG,21,OKC,63,63,2214,442,935,.473,78,222,.351,364,713,.511,.514,254,317,.801,45,339,384,208,70,45,117,108,1216
171,Rudy Gobert\goberru01,C,27,UTA,63,63,2176,358,515,.695,0,0,,358,515,.695,.695,232,372,.624,213,649,862,93,47,127,123,199,948
172,Brandon Goodwin\goodwbr01,PG,24,ATL,34,1,430,76,190,.400,26,87,.299,50,103,.485,.468,28,30,.933,11,61,72,51,12,4,29,43,206
173,Aaron Gordon\gordoaa01,PF,24,ORL,59,59,1940,316,731,.432,68,227,.300,248,504,.492,.479,143,211,.678,103,349,452,217,50,36,95,117,843
174,Eric Gordon\gordoer01,SG,31,HOU,34,13,972,162,438,.370,92,288,.319,70,150,.467,.475,78,103,.757,8,57,65,52,22,12,36,68,494
175,Devonte' Graham\grahade01,PG,24,CHO,63,53,2211,368,963,.382,218,585,.373,150,378,.397,.495,191,233,.820,42,170,212,471,62,15,181,115,1145
176,Treveon Graham\grahatr01,SG,26,TOT,55,20,929,87,242,.360,33,120,.275,54,122,.443,.428,36,56,.643,51,99,150,45,24,6,29,102,243
176,Treveon Graham\grahatr01,SG,26,MIN,33,20,663,62,175,.354,20,83,.241,42,92,.457,.411,27,37,.730,29,71,100,30,17,2,19,66,171
176,Treveon Graham\grahatr01,SG,26,ATL,22,0,266,25,67,.373,13,37,.351,12,30,.400,.470,9,19,.474,22,28,50,15,7,4,10,36,72
177,Jerami Grant\grantje01,PF,25,DEN,64,22,1676,263,558,.471,88,220,.400,175,338,.518,.550,128,172,.744,53,174,227,79,44,52,55,141,742
178,Jerian Grant\grantje02,G,27,WAS,1,0,10,2,2,1.000,1,1,1.000,1,1,1.000,1.250,0,0,,0,1,1,1,0,0,0,1,5
179,Josh Gray\grayjo01,PG,26,NOP,2,0,23,1,2,.500,0,0,,1,2,.500,.500,0,0,,1,1,2,2,0,0,5,1,2
180,Danny Green\greenda02,SG,32,LAL,62,62,1554,180,431,.418,115,305,.377,65,126,.516,.551,32,44,.727,44,163,207,86,76,29,58,132,507
181,Draymond Green\greendr01,PF,29,GSW,43,43,1222,123,316,.389,36,129,.279,87,187,.465,.446,63,83,.759,23,243,266,266,59,33,98,110,345
182,JaMychal Green\greenja01,PF,29,LAC,56,0,1158,128,308,.416,76,208,.365,52,100,.520,.539,32,44,.727,75,277,352,43,25,21,45,151,364
183,Javonte Green\greenja02,SF,26,BOS,44,1,414,49,98,.500,6,23,.261,43,75,.573,.531,23,36,.639,18,62,80,23,23,7,18,37,127
184,Jeff Green\greenje02,PF,33,TOT,41,2,774,120,270,.444,49,142,.345,71,128,.555,.535,58,74,.784,23,91,114,33,22,16,36,70,347
184,Jeff Green\greenje02,PF,33,UTA,30,2,553,75,195,.385,34,104,.327,41,91,.451,.472,49,63,.778,14,67,81,20,12,10,27,46,233
184,Jeff Green\greenje02,PF,33,HOU,11,0,221,45,75,.600,15,38,.395,30,37,.811,.700,9,11,.818,9,24,33,13,10,6,9,24,114
185,Blake Griffin\griffbl01,PF,30,DET,18,18,512,88,250,.352,27,111,.243,61,139,.439,.406,76,98,.776,17,67,84,59,7,7,40,27,279
186,Marko Guduric\gudurma01,SG,24,MEM,42,0,476,61,154,.396,25,81,.309,36,73,.493,.477,23,25,.920,14,57,71,45,12,8,36,34,170
187,Kyle Guy\guyky01,SG,22,SAC,2,0,4,1,2,.500,0,1,.000,1,1,1.000,.500,0,0,,0,0,0,0,0,0,0,0,2
188,Rui Hachimura\hachiru01,PF,21,WAS,42,42,1247,226,471,.480,20,73,.274,206,398,.518,.501,97,116,.836,66,190,256,71,35,7,46,91,569
189,Devon Hall\hallde01,SG,24,OKC,5,0,20,1,5,.200,0,2,.000,1,3,.333,.200,3,4,.750,0,1,1,3,0,0,1,1,5
190,Donta Hall\halldo01,PF,22,TOT,5,0,60,4,7,.571,0,0,,4,7,.571,.571,6,11,.545,8,10,18,2,1,2,2,10,14
190,Donta Hall\halldo01,PF,22,DET,4,0,48,1,4,.250,0,0,,1,4,.250,.250,4,6,.667,6,9,15,2,1,1,2,9,6
190,Donta Hall\halldo01,F,22,BRK,1,0,12,3,3,1.000,0,0,,3,3,1.000,1.000,2,5,.400,2,1,3,0,0,1,0,1,8
191,Dusty Hannahs\hannadu01,SG,26,MEM,2,0,13,4,9,.444,2,3,.667,2,6,.333,.556,2,2,1.000,0,1,1,0,0,0,0,1,12
192,Tim Hardaway Jr.\hardati02,SG,27,DAL,64,51,1856,352,804,.438,190,463,.410,162,341,.475,.556,128,158,.810,23,180,203,127,40,5,64,109,1022
193,James Harden\hardeja01,SG,30,HOU,62,62,2285,617,1406,.439,274,778,.352,343,628,.546,.536,637,740,.861,64,333,397,458,109,56,274,211,2145
194,Maurice Harkless\harklma01,SF,26,TOT,62,48,1427,142,283,.502,34,98,.347,108,185,.584,.562,39,66,.591,55,185,240,68,58,33,53,148,357
194,Maurice Harkless\harklma01,SF,26,LAC,50,38,1141,112,217,.516,27,73,.370,85,144,.590,.578,24,42,.571,47,153,200,48,49,30,46,120,275
194,Maurice Harkless\harklma01,SF,26,NYK,12,10,286,30,66,.455,7,25,.280,23,41,.561,.508,15,24,.625,8,32,40,20,9,3,7,28,82
195,Jared Harper\harpeja01,PG,22,PHO,3,0,8,1,4,.250,0,2,.000,1,2,.500,.250,0,0,,0,0,0,0,0,0,0,0,2
196,Montrezl Harrell\harremo01,C,26,LAC,63,2,1749,471,812,.580,0,18,.000,471,794,.593,.580,231,351,.658,163,282,445,107,39,72,108,146,1173
197,Gary Harris\harriga01,SG,25,DEN,56,55,1780,218,519,.420,70,210,.333,148,309,.479,.487,75,92,.815,26,137,163,118,76,14,60,116,581
198,Joe Harris\harrijo01,SF,28,BRK,64,64,1975,338,716,.472,154,375,.411,184,341,.540,.580,62,84,.738,60,216,276,132,39,16,95,140,892
199,Tobias Harris\harrito02,PF,27,PHI,65,65,2243,494,1046,.472,117,323,.362,377,723,.521,.528,154,191,.806,54,386,440,205,49,35,97,148,1259
200,Shaquille Harrison\harrish01,SF,26,CHI,43,10,484,77,165,.467,16,42,.381,61,123,.496,.515,39,50,.780,22,64,86,49,34,19,19,55,209
201,Josh Hart\hartjo01,SF,24,NOP,58,14,1585,204,488,.418,113,328,.345,91,160,.569,.534,68,92,.739,55,318,373,95,59,21,66,147,589
202,Isaiah Hartenstein\harteis01,C,21,HOU,23,2,266,44,67,.657,0,5,.000,44,62,.710,.657,19,28,.679,29,61,90,18,9,12,16,41,107
203,Udonis Haslem\hasleud01,PF,39,MIA,3,0,21,1,6,.167,0,2,.000,1,4,.250,.167,3,4,.750,0,8,8,1,0,0,0,3,5
204,Jaxson Hayes\hayesja02,C,19,NOP,57,12,970,156,237,.658,1,4,.250,155,233,.665,.660,110,175,.629,87,143,230,52,23,53,42,144,423
205,Gordon Hayward\haywago01,SF,29,BOS,46,46,1536,311,621,.501,74,192,.385,237,429,.552,.560,99,116,.853,47,256,303,191,35,21,83,83,795
206,John Henson\hensojo01,PF,29,TOT,40,8,600,95,171,.556,8,36,.222,87,135,.644,.579,23,46,.500,46,116,162,54,24,42,36,78,221
206,John Henson\hensojo01,PF,29,CLE,29,2,412,61,120,.508,6,31,.194,55,89,.618,.533,17,33,.515,32,82,114,43,16,32,21,55,145
206,John Henson\hensojo01,PF,29,DET,11,6,188,34,51,.667,2,5,.400,32,46,.696,.686,6,13,.462,14,34,48,11,8,10,15,23,76
207,Dewan Hernandez\hernade01,C,23,TOR,4,0,11,1,5,.200,0,1,.000,1,4,.250,.200,2,2,1.000,2,5,7,0,1,0,1,6,4
208,Juan Hernangómez\hernaju01,PF,24,TOT,48,14,833,100,247,.405,44,129,.341,56,118,.475,.494,44,71,.620,43,154,197,40,19,9,32,64,288
208,Juan Hernangómez\hernaju01,PF,24,DEN,34,0,422,38,110,.345,15,60,.250,23,50,.460,.414,16,25,.640,24,71,95,22,5,5,18,29,107
208,Juan Hernangómez\hernaju01,PF,24,MIN,14,14,411,62,137,.453,29,69,.420,33,68,.485,.558,28,46,.609,19,83,102,18,14,4,14,35,181
209,Willy Hernangómez\hernawi01,C,25,CHO,31,0,375,74,139,.532,5,22,.227,69,117,.590,.550,37,59,.627,43,91,134,29,10,7,30,32,190
210,Tyler Herro\herroty01,SG,20,MIA,47,6,1280,220,532,.414,99,253,.391,121,279,.434,.507,66,79,.835,14,173,187,91,30,7,72,59,605
211,Kevin Hervey\herveke01,PF,23,OKC,7,0,19,1,11,.091,0,8,.000,1,3,.333,.091,0,0,,0,2,2,1,0,0,0,1,2
212,Mario Hezonja\hezonma01,PF,24,POR,48,4,790,83,194,.428,22,66,.333,61,128,.477,.485,45,55,.818,26,140,166,44,31,9,39,96,233
213,Buddy Hield\hieldbu01,SG,27,SAC,65,44,2064,458,1075,.426,245,626,.391,213,449,.474,.540,113,134,.843,57,253,310,198,61,17,153,152,1274
214,George Hill\hillge01,PG,33,MIL,53,0,1131,180,341,.528,73,154,.474,107,187,.572,.635,72,87,.828,46,112,158,155,43,4,51,77,505
215,Solomon Hill\hillso01,SF,28,TOT,54,4,992,100,248,.403,59,156,.378,41,92,.446,.522,30,42,.714,27,127,154,98,36,12,47,78,289
215,Solomon Hill\hillso01,SF,28,MEM,48,3,901,96,233,.412,56,147,.381,40,86,.465,.532,26,38,.684,24,120,144,94,31,7,40,73,274
215,Solomon Hill\hillso01,SF,28,MIA,6,1,91,4,15,.267,3,9,.333,1,6,.167,.367,4,4,1.000,3,7,10,4,5,5,7,5,15
216,Jaylen Hoard\hoardja01,SF,20,POR,13,0,103,15,32,.469,0,3,.000,15,29,.517,.469,8,13,.615,14,18,32,4,5,0,4,12,38
217,Aaron Holiday\holidaa01,PG,23,IND,58,26,1368,202,496,.407,80,203,.394,122,293,.416,.488,62,72,.861,21,111,132,193,45,13,75,102,546
218,Jrue Holiday\holidjr01,SG,29,NOP,56,56,1958,430,949,.453,117,327,.358,313,622,.503,.515,119,170,.700,72,201,273,382,95,45,164,129,1096
219,Justin Holiday\holidju01,SG,30,IND,65,2,1617,190,432,.440,122,288,.424,68,144,.472,.581,46,59,.780,30,176,206,87,75,42,40,119,548
220,Rondae Hollis-Jefferson\holliro01,SF,25,TOR,52,5,998,139,295,.471,2,17,.118,137,278,.493,.475,95,129,.736,102,152,254,90,44,22,49,105,375
221,Richaun Holmes\holmeri01,C,26,SAC,40,34,1149,213,326,.653,0,0,,213,326,.653,.653,84,104,.808,120,211,331,40,39,55,51,158,510
222,Rodney Hood\hoodro01,SF,27,POR,21,21,619,87,172,.506,35,71,.493,52,101,.515,.608,21,27,.778,10,62,72,32,17,4,19,46,230
223,Al Horford\horfoal01,C,33,PHI,60,57,1848,289,654,.442,89,264,.337,200,390,.513,.510,55,73,.753,92,320,412,244,52,55,65,128,722
224,Talen Horton-Tucker\hortota01,SG,19,LAL,2,0,5,0,1,.000,0,1,.000,0,0,,.000,0,0,,0,0,0,2,1,0,0,0,0
225,Danuel House\houseda01,SF,26,HOU,59,48,1781,213,495,.430,119,323,.368,94,172,.547,.551,68,85,.800,56,195,251,79,66,32,50,121,613
226,Dwight Howard\howardw01,C,34,LAL,63,2,1205,188,257,.732,3,5,.600,185,252,.734,.737,90,184,.489,158,302,460,44,28,76,74,205,469
227,William Howard\howarwi01,SG,26,HOU,2,0,13,0,4,.000,0,4,.000,0,0,,.000,0,0,,0,2,2,1,0,0,1,1,0
228,Kevin Huerter\huertke01,SG,21,ATL,56,48,1760,252,610,.413,127,334,.380,125,276,.453,.517,53,64,.828,35,193,228,213,51,27,87,139,684
229,De'Andre Hunter\huntede01,SF,22,ATL,63,62,2018,280,683,.410,108,304,.355,172,379,.454,.489,110,144,.764,44,242,286,112,44,18,103,182,778
230,Chandler Hutchison\hutchch01,SF,23,CHI,28,10,527,80,175,.457,12,38,.316,68,137,.496,.491,46,78,.590,18,90,108,26,27,7,27,47,218
231,Serge Ibaka\ibakase01,C,30,TOR,50,27,1377,323,623,.518,66,166,.398,257,457,.562,.571,89,119,.748,104,310,414,73,24,42,100,138,801
232,Andre Iguodala\iguodan01,SG,36,MIA,14,0,259,25,51,.490,9,24,.375,16,27,.593,.578,2,8,.250,10,43,53,28,8,16,17,28,61
233,Ersan İlyasova\ilyaser01,PF,32,MIL,57,8,909,138,292,.473,47,125,.376,91,167,.545,.553,66,79,.835,60,220,280,47,23,14,34,88,389
234,Joe Ingles\inglejo01,SF,32,UTA,65,38,1948,222,501,.443,124,313,.396,98,188,.521,.567,69,89,.775,24,235,259,333,59,9,129,139,637
235,Brandon Ingram\ingrabr01,PF,22,NOP,57,57,1951,476,1026,.464,139,362,.384,337,664,.508,.532,290,338,.858,50,308,358,241,56,38,175,165,1381
236,Kyrie Irving\irvinky01,PG,27,BRK,20,20,658,199,416,.478,56,142,.394,143,274,.522,.546,94,102,.922,22,81,103,128,27,10,52,53,548
237,Jonathan Isaac\isaacjo01,SF,22,ORL,33,32,965,155,329,.471,32,93,.344,123,236,.521,.520,58,75,.773,58,170,228,44,51,78,47,81,400
238,Wesley Iwundu\iwundwe01,SF,25,ORL,45,18,810,77,194,.397,21,67,.313,56,127,.441,.451,62,76,.816,23,90,113,46,25,11,18,62,237
239,Frank Jackson\jacksfr01,PG,21,NOP,52,1,660,99,257,.385,39,120,.325,60,137,.438,.461,48,64,.750,19,53,72,42,15,4,43,67,285
240,Jaren Jackson Jr.\jacksja02,C,20,MEM,55,55,1555,338,723,.467,141,355,.397,197,368,.535,.565,130,175,.743,54,203,257,76,37,88,95,224,947
241,Josh Jackson\jacksjo02,SG,22,MEM,19,0,370,70,159,.440,23,72,.319,47,87,.540,.513,33,48,.688,11,53,64,33,18,9,26,39,196
242,Justin Jackson\jacksju01,PF,24,DAL,59,2,937,124,312,.397,45,151,.298,79,161,.491,.470,36,44,.818,27,116,143,49,12,10,12,58,329
243,Reggie Jackson\jacksre01,PG,29,TOT,24,12,590,110,267,.412,46,117,.393,64,150,.427,.498,38,47,.809,16,57,73,105,10,5,44,41,304
243,Reggie Jackson\jacksre01,PG,29,DET,14,10,381,76,198,.384,31,82,.378,45,116,.388,.462,26,33,.788,11,30,41,72,8,1,23,21,209
243,Reggie Jackson\jacksre01,PG,29,LAC,10,2,209,34,69,.493,15,35,.429,19,34,.559,.601,12,14,.857,5,27,32,33,2,4,21,20,95
244,Justin James\jamesju01,SG,23,SAC,34,0,218,33,78,.423,9,26,.346,24,52,.462,.481,10,21,.476,6,24,30,16,6,9,8,16,85
245,LeBron James\jamesle01,PG,35,LAL,61,61,2129,592,1195,.495,135,388,.348,457,807,.566,.552,241,345,.699,61,423,484,643,75,31,244,109,1560
246,Amile Jefferson\jeffeam01,PF,26,ORL,18,0,74,5,14,.357,0,0,,5,14,.357,.357,5,14,.357,10,13,23,4,1,3,3,7,15
247,DaQuan Jeffries\jeffrda01,SG,22,SAC,7,0,26,4,8,.500,1,4,.250,3,4,.750,.563,2,2,1.000,1,1,2,1,1,0,0,3,11
248,Ty Jerome\jeromty01,PG,22,PHO,28,0,315,37,106,.349,13,47,.277,24,59,.407,.410,11,14,.786,6,35,41,43,14,3,18,28,98
249,Alize Johnson\johnsal02,SF,23,IND,13,0,54,7,15,.467,0,0,,7,15,.467,.467,4,6,.667,7,11,18,2,0,0,3,6,18
250,B.J. Johnson\johnsbj01,SF,24,ORL,8,0,46,5,18,.278,1,6,.167,4,12,.333,.306,2,2,1.000,1,5,6,2,2,0,3,0,13
251,Cameron Johnson\johnsca02,PF,23,PHO,50,2,1021,141,333,.423,92,232,.397,49,101,.485,.562,36,47,.766,40,103,143,54,31,16,30,77,410
252,James Johnson\johnsja01,PF,32,TOT,32,1,619,103,215,.479,33,91,.363,70,124,.565,.556,31,48,.646,25,93,118,74,25,32,48,80,270
252,James Johnson\johnsja01,PF,32,MIA,18,0,281,39,87,.448,16,45,.356,23,42,.548,.540,8,14,.571,8,44,52,21,6,13,15,34,102
252,James Johnson\johnsja01,PF,32,MIN,14,1,338,64,128,.500,17,46,.370,47,82,.573,.566,23,34,.676,17,49,66,53,19,19,33,46,168
253,Keldon Johnson\johnske04,SF,20,SAS,10,0,122,19,38,.500,4,9,.444,15,29,.517,.553,7,12,.583,6,17,23,8,6,1,3,10,49
254,Stanley Johnson\johnsst04,PF,23,TOR,20,0,96,8,31,.258,2,13,.154,6,18,.333,.290,5,6,.833,3,19,22,8,4,2,8,10,23
255,Tyler Johnson\johnsty01,SG,27,TOT,32,3,534,67,179,.374,25,87,.287,42,92,.457,.444,30,38,.789,11,43,54,54,12,8,24,46,189
255,Tyler Johnson\johnsty01,SG,27,PHO,31,3,515,65,171,.380,24,83,.289,41,88,.466,.450,24,32,.750,10,42,52,50,12,8,24,43,178
255,Tyler Johnson\johnsty01,G,27,BRK,1,0,19,2,8,.250,1,4,.250,1,4,.250,.313,6,6,1.000,1,1,2,4,0,0,0,3,11
256,Nikola Jokić\jokicni01,C,24,DEN,65,65,2101,512,969,.528,71,226,.314,441,743,.594,.565,218,268,.813,155,508,663,446,77,43,202,200,1313
257,Damian Jones\jonesda03,C,24,ATL,55,27,887,121,178,.680,2,9,.222,119,169,.704,.685,62,84,.738,74,132,206,35,26,40,28,149,306
258,Derrick Jones Jr.\jonesde02,SF,22,MIA,51,15,1249,166,323,.514,34,126,.270,132,197,.670,.567,88,113,.779,57,156,213,57,54,36,27,114,454
259,Tyus Jones\jonesty01,PG,23,MEM,65,6,1232,197,429,.459,47,124,.379,150,305,.492,.514,43,58,.741,9,94,103,285,59,6,55,44,484
260,DeAndre Jordan\jordade01,C,31,BRK,56,6,1234,191,287,.666,0,0,,191,287,.666,.666,83,122,.680,141,420,561,105,18,52,74,114,465
261,Cory Joseph\josepco01,PG,28,SAC,65,22,1565,157,374,.420,48,138,.348,109,236,.462,.484,48,58,.828,37,128,165,222,47,21,65,122,410
262,Mfiondu Kabengele\kabenmf01,C,22,LAC,12,0,64,14,32,.438,9,20,.450,5,12,.417,.578,5,5,1.000,1,10,11,2,2,2,2,9,42
263,Frank Kaminsky\kaminfr01,C,26,PHO,33,13,728,128,283,.452,39,114,.342,89,169,.527,.521,59,88,.670,30,130,160,73,13,10,34,71,354
264,Enes Kanter\kanteen01,C,27,BOS,52,6,902,177,313,.565,1,7,.143,176,306,.575,.567,63,89,.708,142,255,397,49,22,38,52,87,418
265,Luke Kennard\kennalu01,SG,23,DET,28,25,922,151,342,.442,73,183,.399,78,159,.491,.548,67,74,.905,9,89,98,115,12,6,43,65,442
266,Stanton Kidd\kiddst01,SF,27,UTA,4,0,15,0,3,.000,0,1,.000,0,2,.000,.000,0,0,,0,3,3,1,0,0,2,3,0
267,Michael Kidd-Gilchrist\kiddgmi01,PF-SF,26,TOT,21,0,231,19,60,.317,5,20,.250,14,40,.350,.358,9,11,.818,12,43,55,13,2,5,13,32,52
267,Michael Kidd-Gilchrist\kiddgmi01,PF,26,CHO,12,0,160,18,53,.340,5,17,.294,13,36,.361,.387,7,9,.778,9,26,35,10,0,3,7,18,48
267,Michael Kidd-Gilchrist\kiddgmi01,SF,26,DAL,9,0,71,1,7,.143,0,3,.000,1,4,.250,.143,2,2,1.000,3,17,20,3,2,2,6,14,4
268,Louis King\kinglo02,SF,20,DET,10,0,62,8,21,.381,4,11,.364,4,10,.400,.476,0,3,.000,1,9,10,5,2,0,2,10,20
269,Maxi Kleber\klebima01,C,28,DAL,67,21,1729,216,471,.459,108,289,.374,108,182,.593,.573,71,82,.866,101,261,362,80,20,79,50,157,611
270,Brandon Knight\knighbr03,PG,28,TOT,25,3,462,59,167,.353,45,131,.344,14,36,.389,.488,20,34,.588,4,37,41,69,10,3,38,40,183
270,Brandon Knight\knighbr03,PG,28,CLE,16,0,241,28,86,.326,19,64,.297,9,22,.409,.436,4,13,.308,3,17,20,31,5,2,16,20,79
270,Brandon Knight\knighbr03,PG,28,DET,9,3,221,31,81,.383,26,67,.388,5,14,.357,.543,16,21,.762,1,20,21,38,5,1,22,20,104
271,Kevin Knox\knoxke01,SF,20,NYK,65,4,1166,144,401,.359,65,199,.327,79,202,.391,.440,66,101,.653,28,156,184,61,23,28,45,106,419
272,John Konchar\konchjo01,SG,23,MEM,15,0,167,23,35,.657,4,9,.444,19,26,.731,.714,1,2,.500,18,28,46,21,7,3,6,7,51
273,Furkan Korkmaz\korkmfu01,SG,22,PHI,64,12,1398,222,514,.432,126,317,.397,96,197,.487,.554,53,72,.736,16,132,148,70,36,15,52,89,623
274,Luke Kornet\kornelu01,C,24,CHI,36,14,559,82,187,.439,31,108,.287,51,79,.646,.521,20,28,.714,22,62,84,32,11,26,14,54,215
275,Kyle Korver\korveky01,SF,38,MIL,51,0,847,113,264,.428,88,212,.415,25,52,.481,.595,28,34,.824,14,92,106,62,23,12,44,69,342
276,Rodions Kurucs\kurucro01,PF,21,BRK,40,4,517,62,138,.449,26,68,.382,36,70,.514,.543,19,30,.633,19,84,103,35,17,3,35,71,169
277,Kyle Kuzma\kuzmaky01,PF,24,LAL,55,7,1359,258,596,.433,74,243,.305,184,353,.521,.495,100,135,.741,48,201,249,71,21,22,86,108,690
278,Skal Labissière\labissk01,C,23,POR,33,1,567,81,147,.551,3,13,.231,78,134,.582,.561,25,33,.758,65,104,169,42,7,31,30,89,190
279,Jeremy Lamb\lambje01,SG,27,IND,46,42,1291,216,479,.451,53,158,.335,163,321,.508,.506,92,110,.836,24,176,200,96,55,22,50,104,577
280,Romeo Langford\langfro01,SG,20,BOS,27,1,298,24,64,.375,5,23,.217,19,41,.463,.414,16,23,.696,14,18,32,6,8,6,9,29,69
281,Zach LaVine\lavinza01,SG,24,CHI,60,60,2085,539,1199,.450,184,484,.380,355,715,.497,.526,268,334,.802,41,248,289,254,88,28,206,131,1530
282,Vic Law\lawvi01,SF,24,ORL,5,0,9,0,3,.000,0,1,.000,0,2,.000,.000,0,2,.000,0,1,1,0,0,0,0,0,0
283,Jake Layman\laymaja01,PF,25,MIN,23,2,505,81,179,.453,24,72,.333,57,107,.533,.520,24,32,.750,17,40,57,15,17,10,24,47,210
284,T.J. Leaf\leaftj01,PF,22,IND,25,1,193,30,69,.435,5,14,.357,25,55,.455,.471,7,12,.583,21,43,64,6,8,3,7,18,72
285,Jalen Lecque\lecquja01,PG,19,PHO,4,0,26,4,10,.400,0,4,.000,4,6,.667,.400,2,2,1.000,0,0,0,2,0,0,1,2,10
286,Courtney Lee\leeco01,SG,34,DAL,24,9,345,40,82,.488,21,47,.447,19,35,.543,.616,6,7,.857,7,25,32,12,18,6,11,33,107
287,Damion Lee\leeda03,SG,27,GSW,49,36,1423,213,511,.417,85,239,.356,128,272,.471,.500,110,126,.873,32,207,239,133,50,6,67,116,621
288,Alex Len\lenal01,C,26,TOT,49,9,895,168,302,.556,14,56,.250,154,246,.626,.579,58,91,.637,95,199,294,47,22,46,50,114,408
288,Alex Len\lenal01,C,26,ATL,40,9,745,142,260,.546,14,56,.250,128,204,.627,.573,51,81,.630,69,161,230,42,20,33,39,93,349
288,Alex Len\lenal01,C,26,SAC,9,0,150,26,42,.619,0,0,,26,42,.619,.619,7,10,.700,26,38,64,5,2,13,11,21,59
289,Kawhi Leonard\leonaka01,SF,28,LAC,52,52,1676,483,1032,.468,110,296,.372,373,736,.507,.521,322,363,.887,52,324,376,258,94,33,143,100,1398
290,Meyers Leonard\leoname01,C,27,MIA,49,49,987,116,223,.520,51,119,.429,65,104,.625,.635,17,26,.654,27,221,248,53,13,15,35,103,300
291,Caris LeVert\leverca01,SG,25,BRK,40,26,1159,259,626,.414,72,193,.373,187,433,.432,.471,119,165,.721,42,119,161,166,45,7,102,72,709
292,Damian Lillard\lillada01,PG,29,POR,59,59,2185,541,1184,.457,228,582,.392,313,602,.520,.553,396,447,.886,30,225,255,462,59,21,171,102,1706
293,Nassir Little\littlna01,PF,19,POR,48,5,573,65,151,.430,14,59,.237,51,92,.554,.477,28,44,.636,31,77,108,22,13,14,15,72,172
294,Kevon Looney\looneke01,C,23,GSW,20,4,262,29,79,.367,1,14,.071,28,65,.431,.373,9,12,.750,28,38,66,20,12,6,12,34,68
295,Brook Lopez\lopezbr01,C,31,MIL,62,61,1651,248,581,.427,86,289,.298,162,292,.555,.501,102,125,.816,43,233,276,95,44,155,65,151,684
296,Robin Lopez\lopezro01,C,31,MIL,61,4,876,140,277,.505,34,98,.347,106,179,.592,.567,25,45,.556,52,95,147,42,10,41,56,83,339
297,Kevin Love\loveke01,PF,31,CLE,56,56,1780,327,727,.450,146,390,.374,181,337,.537,.550,187,219,.854,54,493,547,178,33,19,140,90,987
298,Kyle Lowry\lowryky01,PG,33,TOR,52,52,1901,309,741,.417,153,432,.354,156,309,.505,.520,255,296,.861,30,221,251,399,70,22,154,168,1026
299,Timothé Luwawu-Cabarrot\luwawti01,SG,24,BRK,40,0,692,86,204,.422,44,117,.376,42,87,.483,.529,55,66,.833,24,71,95,25,16,6,32,84,271
300,Trey Lyles\lylestr01,PF,24,SAS,63,53,1271,153,343,.446,65,168,.387,88,175,.503,.541,33,45,.733,71,290,361,69,28,28,39,98,404
301,Daryl Macon\maconda01,SG,24,MIA,4,0,14,1,3,.333,1,2,.500,0,1,.000,.500,0,0,,0,0,0,1,0,0,2,1,3
302,J.P. Macura\macurjp01,SG,24,CLE,1,0,1,0,0,,0,0,,0,0,,,0,0,,0,0,0,0,0,0,0,0,0
303,Josh Magette\magetjo01,PG,30,ORL,8,0,38,5,15,.333,1,4,.250,4,11,.364,.367,1,2,.500,1,5,6,5,3,1,5,4,12
304,Ian Mahinmi\mahinia01,C,33,WAS,38,35,808,104,210,.495,5,26,.192,99,184,.538,.507,70,113,.619,78,140,218,49,31,44,45,114,283
305,Thon Maker\makerth01,C,22,DET,60,14,776,93,193,.482,22,64,.344,71,129,.550,.539,73,110,.664,54,113,167,43,25,39,45,102,281
306,Terance Mann\mannte01,SG,23,LAC,35,6,271,22,54,.407,3,12,.250,19,42,.452,.435,9,12,.750,4,29,33,38,8,5,14,36,56
307,Boban Marjanović\marjabo01,C,31,DAL,38,2,342,99,176,.563,4,15,.267,95,161,.590,.574,36,48,.750,56,102,158,13,7,7,26,48,238
308,Lauri Markkanen\markkla01,PF,22,CHI,50,50,1492,251,591,.425,109,317,.344,142,274,.518,.517,126,153,.824,60,253,313,74,42,23,81,96,737
309,Caleb Martin\martica02,SF,24,CHO,18,1,317,37,84,.440,20,37,.541,17,47,.362,.560,17,21,.810,10,28,38,23,12,7,15,32,111
310,Cody Martin\martico01,SF,24,CHO,48,3,903,89,207,.430,18,77,.234,71,130,.546,.473,42,65,.646,38,120,158,95,39,9,44,78,238
311,Jeremiah Martin\martije02,PG,23,BRK,4,0,25,4,13,.308,1,6,.167,3,7,.429,.346,0,0,,0,4,4,4,2,1,1,1,9
312,Kelan Martin\martike03,SF,24,MIN,31,4,495,71,181,.392,25,96,.260,46,85,.541,.461,30,31,.968,12,84,96,23,7,9,20,51,197
313,Frank Mason III\masonfr01,PG,25,MIL,6,0,53,5,19,.263,2,10,.200,3,9,.333,.316,2,4,.500,3,5,8,11,2,0,6,4,14
314,Garrison Mathews\mathega01,SG,23,WAS,18,0,227,24,56,.429,19,46,.413,5,10,.500,.598,31,34,.912,6,18,24,10,8,1,8,32,98
315,Wesley Matthews\matthwe02,SG,33,MIL,63,63,1555,161,407,.396,103,283,.364,58,124,.468,.522,51,66,.773,21,139,160,91,37,9,41,92,476
316,Patrick McCaw\mccawpa01,SF,24,TOR,37,12,908,67,162,.414,23,71,.324,44,91,.484,.485,13,18,.722,19,67,86,79,39,4,29,60,170
317,CJ McCollum\mccolcj01,SG,28,POR,63,63,2275,563,1233,.457,177,464,.381,386,769,.502,.528,125,166,.753,42,215,257,274,48,39,118,162,1428
318,T.J. McConnell\mccontj01,PG,27,IND,63,3,1188,187,362,.517,5,15,.333,182,347,.524,.523,30,36,.833,32,131,163,316,44,11,86,69,409
319,Jalen McDaniels\mcdanja01,PF,22,CHO,16,0,293,33,70,.471,9,24,.375,24,46,.522,.536,14,17,.824,15,50,65,13,8,3,11,36,89
320,Doug McDermott\mcderdo01,PF,28,IND,62,0,1242,241,491,.491,118,265,.445,123,226,.544,.611,43,52,.827,23,133,156,70,9,4,40,106,643
321,JaVale McGee\mcgeeja01,C,32,LAL,62,62,1034,184,287,.641,3,6,.500,181,281,.644,.646,49,75,.653,115,246,361,34,33,92,47,148,420
322,Rodney McGruder\mcgruro01,SG,28,LAC,50,3,749,61,156,.391,22,79,.278,39,77,.506,.462,15,28,.536,26,102,128,30,23,8,21,67,159
323,Alfonzo McKinnie\mckinal01,SF,27,CLE,40,1,593,73,171,.427,14,65,.215,59,106,.557,.468,22,31,.710,37,76,113,14,23,8,26,72,182
324,Jordan McLaughlin\mclaujo01,PG,23,MIN,30,2,590,87,178,.489,29,76,.382,58,102,.569,.570,26,39,.667,7,42,49,125,34,4,31,31,229
325,Ben McLemore\mclembe01,SG,26,HOU,64,19,1451,213,474,.449,158,394,.401,55,80,.688,.616,48,64,.750,20,119,139,54,38,12,46,136,632
326,Jordan McRae\mcraejo01,SG,28,TOT,37,4,784,149,366,.407,45,126,.357,104,240,.433,.469,83,109,.761,18,106,124,93,21,16,43,73,426
326,Jordan McRae\mcraejo01,SG,28,WAS,29,4,654,133,317,.420,40,106,.377,93,211,.441,.483,64,83,.771,17,87,104,82,19,15,38,61,370
326,Jordan McRae\mcraejo01,SG,28,DEN,4,0,32,2,6,.333,2,4,.500,0,2,.000,.500,3,4,.750,1,4,5,4,2,1,0,2,9
326,Jordan McRae\mcraejo01,SG,28,DET,4,0,98,14,43,.326,3,16,.188,11,27,.407,.360,16,22,.727,0,15,15,7,0,0,5,10,47
327,Nicolò Melli\mellini01,C,29,NOP,53,6,903,123,279,.441,65,180,.361,58,99,.586,.557,44,60,.733,37,120,157,69,33,19,43,108,355
328,De'Anthony Melton\meltode01,PG,21,MEM,53,8,1041,150,358,.419,37,119,.311,113,239,.473,.471,90,113,.796,39,158,197,159,67,19,79,95,427
329,Chimezie Metu\metuch01,PF,22,SAS,16,0,73,20,35,.571,0,1,.000,20,34,.588,.571,6,8,.750,10,16,26,6,1,4,5,4,46
330,Khris Middleton\middlkh01,SF,28,MIL,56,53,1686,430,870,.494,135,327,.413,295,543,.543,.572,182,200,.910,42,304,346,233,52,7,114,125,1177
331,Eric Mika\mikaer01,PF,25,SAC,1,0,19,2,3,.667,0,0,,2,3,.667,.667,2,2,1.000,2,5,7,0,0,0,0,5,6
332,C.J. Miles\milescj01,SG,32,WAS,10,0,161,19,59,.322,11,35,.314,8,24,.333,.415,15,20,.750,4,8,12,12,10,4,4,14,64
333,Malcolm Miller\millema01,SF,26,TOR,25,1,125,8,24,.333,6,19,.316,2,5,.400,.458,1,6,.167,1,13,14,8,4,2,3,12,23
334,Patty Mills\millspa02,PG,31,SAS,63,1,1430,247,576,.429,148,389,.380,99,187,.529,.557,93,108,.861,19,80,99,112,52,6,51,98,735
335,Paul Millsap\millspa01,PF,34,DEN,44,41,1075,188,387,.486,48,109,.440,140,278,.504,.548,105,126,.833,87,173,260,70,38,28,61,127,529
336,Shake Milton\miltosh01,SG,23,PHI,32,16,611,108,217,.498,48,106,.453,60,111,.541,.608,39,51,.765,11,57,68,71,19,6,38,69,303
337,Donovan Mitchell\mitchdo01,SG,23,UTA,64,64,2201,566,1249,.453,158,432,.366,408,817,.499,.516,255,297,.859,47,234,281,269,69,13,169,157,1545
338,Naz Mitrou-Long\mitrona01,SG,26,IND,3,0,43,6,16,.375,2,11,.182,4,5,.800,.438,0,0,,0,6,6,7,1,1,2,1,14
339,Adam Mokoka\mokokad01,SG,21,CHI,11,0,112,12,28,.429,6,15,.400,6,13,.462,.536,2,4,.500,7,3,10,4,4,0,2,17,32
340,Malik Monk\monkma01,SG,21,CHO,55,1,1169,212,488,.434,58,204,.284,154,284,.542,.494,82,100,.820,27,130,157,114,25,16,77,74,564
341,Matt Mooney\moonema01,SG,22,CLE,4,0,19,1,4,.250,0,2,.000,1,2,.500,.250,0,0,,0,3,3,1,2,1,0,1,2
342,E'Twaun Moore\mooreet01,SG,30,NOP,52,5,972,177,417,.424,62,163,.380,115,254,.453,.499,29,43,.674,30,96,126,74,29,10,38,77,445
343,Ja Morant\moranja01,PG,20,MEM,60,60,1812,400,822,.487,52,146,.356,348,676,.515,.518,211,272,.776,45,168,213,420,55,15,194,90,1063
344,Juwan Morgan\morgaju01,PF,22,UTA,16,0,74,9,17,.529,1,5,.200,8,12,.667,.559,0,0,,5,14,19,2,0,1,3,7,19
345,Marcus Morris\morrima03,SF-PF,30,TOT,56,56,1746,325,754,.431,133,327,.407,192,427,.450,.519,172,209,.823,55,229,284,78,42,27,90,165,955
345,Marcus Morris\morrima03,SF,30,NYK,43,43,1387,281,636,.442,116,264,.439,165,372,.444,.533,163,198,.823,48,185,233,59,34,17,73,128,841
345,Marcus Morris\morrima03,PF,30,LAC,13,13,359,44,118,.373,17,63,.270,27,55,.491,.445,9,11,.818,7,44,51,19,8,10,17,37,114
346,Markieff Morris\morrima02,PF,30,TOT,53,16,1109,189,425,.445,81,210,.386,108,215,.502,.540,65,83,.783,34,165,199,74,28,15,75,120,524
346,Markieff Morris\morrima02,PF,30,DET,44,16,988,175,389,.450,75,189,.397,100,200,.500,.546,61,79,.772,24,149,173,69,26,11,70,104,486
346,Markieff Morris\morrima02,PF,30,LAL,9,0,121,14,36,.389,6,21,.286,8,15,.533,.472,4,4,1.000,10,16,26,5,2,4,5,16,38
347,Monte Morris\morrimo01,PG,24,DEN,65,8,1402,222,484,.459,54,144,.375,168,340,.494,.514,51,62,.823,20,92,112,230,53,16,45,64,549
348,Johnathan Motley\motlejo01,PF,24,LAC,13,0,41,11,15,.733,1,1,1.000,10,14,.714,.767,5,7,.714,3,7,10,8,3,0,5,6,28
349,Emmanuel Mudiay\mudiaem01,PG,23,UTA,49,1,762,136,291,.467,27,78,.346,109,213,.512,.514,52,69,.754,17,99,116,107,19,10,66,66,351
350,Mychal Mulder\muldemy01,SG,25,GSW,7,3,204,26,67,.388,16,52,.308,10,15,.667,.507,9,12,.750,3,20,23,8,2,1,5,20,77
351,Dejounte Murray\murrade01,PG,23,SAS,59,51,1468,260,548,.474,35,92,.380,225,456,.493,.506,75,94,.798,67,272,339,241,100,16,110,133,630
352,Jamal Murray\murraja01,PG,22,DEN,55,55,1804,385,846,.455,105,304,.345,280,542,.517,.517,158,177,.893,42,175,217,266,64,16,124,97,1033
353,Džanan Musa\musadz01,SF,20,BRK,36,0,414,52,141,.369,16,66,.242,36,75,.480,.426,33,44,.750,19,54,73,32,13,1,31,26,153
354,Mike Muscala\muscami01,C,28,OKC,41,0,492,64,159,.403,43,120,.358,21,39,.538,.538,18,22,.818,13,81,94,34,8,11,14,51,189
355,Sviatoslav Mykhailiuk\mykhasv01,SF,22,DET,56,27,1265,166,405,.410,115,285,.404,51,120,.425,.552,57,70,.814,17,87,104,106,41,4,61,87,504
356,Abdel Nader\naderab01,SF,26,OKC,48,5,756,100,220,.455,39,105,.371,61,115,.530,.543,48,62,.774,14,76,90,35,20,20,36,65,287
357,Larry Nance Jr.\nancela02,C,27,CLE,56,10,1472,229,431,.531,56,159,.352,173,272,.636,.596,50,74,.676,106,303,409,123,56,22,60,91,564
358,Shabazz Napier\napiesh01,PG,28,TOT,52,31,1261,174,426,.408,72,227,.317,102,199,.513,.493,119,144,.826,25,124,149,256,67,10,115,95,539
358,Shabazz Napier\napiesh01,PG,28,MIN,36,22,856,114,283,.403,47,159,.296,67,124,.540,.486,72,88,.818,17,93,110,187,40,7,76,62,347
358,Shabazz Napier\napiesh01,PG,28,WAS,16,9,405,60,143,.420,25,68,.368,35,75,.467,.507,47,56,.839,8,31,39,69,27,3,39,33,192
359,Raul Neto\netora01,PG,27,PHI,49,3,565,79,175,.451,28,71,.394,51,104,.490,.531,26,31,.839,11,41,52,77,22,5,42,43,212
360,Malik Newman\newmama01,SG,22,CLE,1,0,4,0,2,.000,0,1,.000,0,1,.000,.000,2,2,1.000,0,0,0,0,0,0,1,0,2
361,Georges Niang\niangge01,PF,26,UTA,59,0,785,120,271,.443,77,188,.410,43,83,.518,.585,19,22,.864,14,97,111,35,13,5,26,65,336
362,Joakim Noah\noahjo01,C,34,LAC,1,0,10,0,0,,0,0,,0,0,,,1,2,.500,2,2,4,1,0,1,0,4,1
363,Nerlens Noel\noelne01,C,25,OKC,55,6,1014,174,254,.685,1,3,.333,173,251,.689,.687,75,98,.765,82,189,271,53,56,82,54,143,424
364,Zach Norvell\norveza01,SG,22,TOT,5,0,41,3,12,.250,3,8,.375,0,4,.000,.375,1,1,1.000,0,6,6,3,2,0,3,4,10
364,Zach Norvell\norveza01,SG,22,LAL,2,0,5,0,1,.000,0,0,,0,1,.000,.000,0,0,,0,1,1,0,0,0,0,0,0
364,Zach Norvell\norveza01,SG,22,GSW,3,0,36,3,11,.273,3,8,.375,0,3,.000,.409,1,1,1.000,0,5,5,3,2,0,3,4,10
365,Jaylen Nowell\nowelja01,SG,20,MIN,15,0,151,19,53,.358,3,26,.115,16,27,.593,.387,16,17,.941,3,10,13,19,3,1,3,11,57
366,Frank Ntilikina\ntilila01,PG,21,NYK,57,26,1187,131,333,.393,44,137,.321,87,196,.444,.459,51,59,.864,23,98,121,172,54,16,71,142,357
367,Kendrick Nunn\nunnke01,SG,24,MIA,62,62,1846,381,850,.448,131,362,.362,250,488,.512,.525,77,92,.837,19,149,168,210,51,11,101,142,970
368,Jusuf Nurkić\nurkiju01,C,25,POR,1,1,33,5,11,.455,0,1,.000,5,10,.500,.455,8,8,1.000,2,7,9,5,2,6,4,6,18
369,David Nwaba\nwabada01,SF,27,BRK,20,0,268,37,71,.521,12,28,.429,25,43,.581,.606,18,27,.667,8,37,45,8,11,12,8,32,104
370,Royce O'Neale\onealro01,PF,26,UTA,65,56,1897,146,332,.440,84,218,.385,62,114,.544,.566,36,49,.735,22,326,348,166,49,28,54,184,412
371,Kyle O'Quinn\oquinky01,C,29,PHI,26,1,258,35,72,.486,7,23,.304,28,49,.571,.535,10,19,.526,32,66,98,35,5,22,18,35,87
372,Semi Ojeleye\ojelese01,PF,25,BOS,62,5,906,65,159,.409,36,98,.367,29,61,.475,.522,25,28,.893,24,102,126,32,18,5,12,67,191
373,Jahlil Okafor\okafoja01,C,24,NOP,28,9,424,88,144,.611,1,2,.500,87,142,.613,.615,37,58,.638,46,73,119,36,7,19,36,63,214
374,Elie Okobo\okoboel01,PG,22,PHO,54,3,707,72,181,.398,25,71,.352,47,110,.427,.467,46,67,.687,16,72,88,113,24,4,38,53,215
375,Josh Okogie\okogijo01,SG,21,MIN,62,28,1547,170,398,.427,41,154,.266,129,244,.529,.479,152,191,.796,87,181,268,99,68,26,87,139,533
376,KZ Okpala\okpalkz01,SF,20,MIA,5,0,26,3,5,.600,0,1,.000,3,4,.750,.600,1,2,.500,1,4,5,1,2,1,1,2,7
377,Victor Oladipo\oladivi01,SG,27,IND,13,10,337,63,161,.391,21,69,.304,42,92,.457,.457,32,41,.780,7,34,41,39,11,3,28,21,179
378,Kelly Olynyk\olynyke01,C,28,MIA,59,6,1089,151,317,.476,80,185,.432,71,132,.538,.603,70,82,.854,37,222,259,97,38,18,63,144,452
379,Miye Oni\onimi01,SG,22,UTA,5,0,11,0,2,.000,0,1,.000,0,1,.000,.000,0,0,,0,2,2,0,0,0,1,0,0
380,Cedi Osman\osmande01,SF,24,CLE,65,65,1910,266,609,.437,123,321,.383,143,288,.497,.538,63,94,.670,39,192,231,154,54,16,91,160,718
381,Kelly Oubre Jr.\oubreke01,SF,24,PHO,56,55,1933,373,826,.452,108,307,.352,265,519,.511,.517,192,246,.780,67,294,361,85,71,40,83,192,1046
382,Tariq Owens\owensta01,PF,24,PHO,3,0,15,1,5,.200,0,2,.000,1,3,.333,.200,2,2,1.000,2,1,3,0,1,0,0,1,4
383,Jeremy Pargo\pargoje01,PG,33,GSW,3,0,44,11,22,.500,3,7,.429,8,15,.533,.568,0,1,.000,1,2,3,8,1,0,4,8,25
384,Jabari Parker\parkeja01,PF,24,TOT,33,23,852,199,399,.499,31,116,.267,168,283,.594,.538,55,74,.743,54,141,195,60,42,15,60,94,484
384,Jabari Parker\parkeja01,PF,24,ATL,32,23,837,198,393,.504,31,115,.270,167,278,.601,.543,53,72,.736,54,137,191,58,42,15,60,93,480
384,Jabari Parker\parkeja01,PF,24,SAC,1,0,15,1,6,.167,0,1,.000,1,5,.200,.167,2,2,1.000,0,4,4,2,0,0,0,1,4
385,Chandler Parsons\parsoch01,SF,31,ATL,5,0,54,5,18,.278,4,14,.286,1,4,.250,.389,0,0,,1,6,7,3,4,1,3,3,14
386,Eric Paschall\pascher01,PF,23,GSW,60,26,1654,318,640,.497,37,129,.287,281,511,.550,.526,164,212,.774,82,193,275,127,32,13,94,125,837
387,Anžejs Pasečņiks\pasecan01,C,24,WAS,24,0,405,56,106,.528,0,2,.000,56,104,.538,.528,32,54,.593,39,60,99,17,8,12,22,65,144
388,Patrick Patterson\pattepa01,PF,30,LAC,52,18,629,78,190,.411,56,143,.392,22,47,.468,.558,27,34,.794,30,95,125,33,6,3,18,42,239
389,Justin Patton\pattoju01,C,22,OKC,5,0,24,4,10,.400,1,4,.250,3,6,.500,.450,0,0,,1,4,5,2,0,0,2,4,9
390,Chris Paul\paulch01,PG,34,OKC,63,63,2003,394,805,.489,101,279,.362,293,526,.557,.552,225,250,.900,21,289,310,426,98,9,137,139,1114
391,Cameron Payne\payneca01,G,25,PHO,1,0,19,4,7,.571,1,2,.500,3,5,.600,.643,0,0,,0,3,3,2,2,1,1,0,9
392,Elfrid Payton\paytoel01,PG,25,NYK,45,36,1246,193,440,.439,14,69,.203,179,371,.482,.455,49,86,.570,52,160,212,323,70,17,96,89,449
393,Gary Payton II\paytoga02,PG,27,WAS,29,17,432,48,116,.414,13,46,.283,35,70,.500,.470,4,8,.500,26,54,80,48,33,7,20,54,113
394,Norvel Pelle\pelleno01,C,26,PHI,20,0,178,18,35,.514,0,0,,18,35,.514,.514,6,12,.500,16,44,60,7,1,25,13,39,42
395,Theo Pinson\pinsoth01,SG,24,BRK,33,0,365,45,155,.290,15,80,.188,30,75,.400,.339,15,16,.938,10,44,54,56,17,4,33,35,120
396,Mason Plumlee\plumlma01,C,29,DEN,53,1,900,153,248,.617,0,4,.000,153,244,.627,.617,74,138,.536,89,193,282,125,29,33,72,125,380
397,Jakob Poeltl\poeltja01,C,24,SAS,59,11,997,138,225,.613,0,0,,138,225,.613,.613,37,76,.487,108,208,316,105,32,86,45,99,313
398,Vincent Poirier\poirivi01,C,26,BOS,21,0,114,16,33,.485,1,2,.500,15,31,.484,.500,6,7,.857,10,24,34,7,2,6,6,23,39
399,Shamorie Ponds\pondssh01,PG,21,TOR,4,0,11,3,5,.600,1,2,.500,2,3,.667,.700,2,2,1.000,0,1,1,2,0,1,0,2,9
400,Jordan Poole\poolejo01,SG,20,GSW,57,14,1274,167,502,.333,74,265,.279,93,237,.392,.406,95,119,.798,9,109,118,134,35,10,74,94,503
401,Kevin Porter Jr.\porteke02,SF,19,CLE,50,3,1162,186,421,.442,53,158,.335,133,263,.506,.505,73,101,.723,22,140,162,109,46,14,93,135,498
402,Michael Porter Jr.\portemi01,PF,21,DEN,48,1,670,141,285,.495,43,102,.422,98,183,.536,.570,33,43,.767,53,146,199,35,20,19,35,75,358
403,Otto Porter\porteot01,SF,26,CHI,14,9,331,62,140,.443,24,62,.387,38,78,.487,.529,19,27,.704,13,35,48,25,15,6,11,31,167
404,Bobby Portis\portibo01,C,24,NYK,66,5,1393,265,589,.450,67,187,.358,198,402,.493,.507,71,93,.763,80,258,338,98,32,18,73,110,668
405,Kristaps Porziņģis\porzikr01,PF,24,DAL,52,52,1636,352,834,.422,129,369,.350,223,465,.480,.499,187,239,.782,91,408,499,91,38,107,86,162,1020
406,Dwight Powell\poweldw01,C,28,DAL,40,37,1061,146,229,.638,10,39,.256,136,190,.716,.659,74,111,.667,75,152,227,59,34,22,36,102,376
407,Norman Powell\powelno01,SG,26,TOR,44,23,1269,259,516,.502,94,236,.398,165,280,.589,.593,109,130,.838,23,138,161,78,55,17,64,93,721
408,Chasson Randle\randlch01,PG,26,GSW,3,0,40,0,4,.000,0,2,.000,0,2,.000,.000,5,6,.833,0,2,2,5,2,0,0,3,5
409,Julius Randle\randlju01,PF,25,NYK,64,64,2080,463,1006,.460,64,231,.277,399,775,.515,.492,258,352,.733,151,471,622,198,51,22,193,178,1248
410,Josh Reaves\reavejo02,SG,22,DAL,2,0,1,0,1,.000,0,0,,0,1,.000,.000,0,0,,0,0,0,0,0,0,0,0,0
411,Cam Reddish\reddica01,SF,20,ATL,58,34,1551,213,554,.384,83,250,.332,130,304,.428,.459,101,126,.802,35,181,216,87,62,28,96,132,610
412,J.J. Redick\redicjj01,SG,35,NOP,55,35,1451,258,573,.450,159,353,.450,99,220,.450,.589,151,167,.904,10,134,144,111,19,9,68,87,826
413,Naz Reid\reidna01,C,20,MIN,30,11,495,100,243,.412,32,97,.330,68,146,.466,.477,37,53,.698,34,90,124,35,19,22,22,83,269
414,Josh Richardson\richajo01,SG,26,PHI,48,46,1474,246,574,.429,70,214,.327,176,360,.489,.490,101,128,.789,37,125,162,148,45,34,91,120,663
415,Austin Rivers\riverau01,SG,27,HOU,61,4,1422,186,440,.423,84,236,.356,102,204,.500,.518,61,91,.670,25,119,144,98,43,10,35,112,517
416,Duncan Robinson\robindu01,SF,25,MIA,65,60,1949,286,613,.467,243,543,.448,43,70,.614,.665,48,53,.906,9,203,212,91,35,15,60,179,863
417,Glenn Robinson III\robingl02,SF,26,TOT,60,52,1743,281,578,.486,74,191,.387,207,387,.535,.550,72,83,.867,78,182,260,96,53,16,53,97,708
417,Glenn Robinson III\robingl02,SF,26,GSW,48,48,1516,244,507,.481,68,170,.400,176,337,.522,.548,63,74,.851,66,160,226,85,45,14,50,82,619
417,Glenn Robinson III\robingl02,SF,26,PHI,12,4,227,37,71,.521,6,21,.286,31,50,.620,.563,9,9,1.000,12,22,34,11,8,2,3,15,89
418,Jerome Robinson\robinje01,SG,22,TOT,56,4,780,82,225,.364,35,110,.318,47,115,.409,.442,22,32,.688,9,98,107,66,23,14,36,86,221
418,Jerome Robinson\robinje01,SG,22,LAC,42,1,476,46,136,.338,19,67,.284,27,69,.391,.408,11,19,.579,5,55,60,46,13,8,26,55,122
418,Jerome Robinson\robinje01,SG,22,WAS,14,3,304,36,89,.404,16,43,.372,20,46,.435,.494,11,13,.846,4,43,47,20,10,6,10,31,99
419,Justin Robinson\robinju01,PG,22,WAS,9,0,49,5,12,.417,3,5,.600,2,7,.286,.542,0,0,,1,4,5,7,0,1,3,2,13
420,Mitchell Robinson\robinmi01,C,21,NYK,61,7,1412,253,341,.742,0,0,,253,341,.742,.742,84,148,.568,186,242,428,36,52,119,37,194,590
421,Isaiah Roby\robyis01,SF,21,OKC,3,0,11,0,1,.000,0,0,,0,1,.000,.000,0,0,,0,2,2,0,0,0,1,1,0
422,Rajon Rondo\rondora01,PG,33,LAL,48,3,984,137,328,.418,41,125,.328,96,203,.473,.480,27,41,.659,23,119,142,240,40,2,91,58,342
423,Derrick Rose\rosede01,PG,31,DET,50,15,1298,369,753,.490,45,147,.306,324,606,.535,.520,121,139,.871,27,94,121,278,40,16,126,49,904
424,Terrence Ross\rosste01,SG,28,ORL,64,0,1746,319,785,.406,163,460,.354,156,325,.480,.510,137,162,.846,13,193,206,75,70,22,62,96,938
425,Terry Rozier\roziete01,PG,25,CHO,63,63,2164,398,941,.423,172,423,.407,226,518,.436,.514,166,190,.874,50,226,276,259,61,10,141,126,1134
426,Ricky Rubio\rubiori01,PG,29,PHO,58,58,1831,255,618,.413,67,191,.351,188,427,.440,.467,182,212,.858,42,224,266,516,91,9,158,147,759
427,D'Angelo Russell\russeda01,PG,23,TOT,45,45,1452,360,846,.426,158,431,.367,202,415,.487,.519,161,199,.809,17,160,177,285,48,13,147,86,1039
427,D'Angelo Russell\russeda01,PG,23,GSW,33,33,1060,273,635,.430,120,321,.374,153,314,.487,.524,113,144,.785,14,108,122,206,31,9,101,64,779
427,D'Angelo Russell\russeda01,PG,23,MIN,12,12,392,87,211,.412,38,110,.345,49,101,.485,.502,48,55,.873,3,52,55,79,17,4,46,22,260
428,Domantas Sabonis\sabondo01,C,23,IND,62,62,2159,458,848,.540,17,67,.254,441,781,.565,.550,214,296,.723,189,582,771,310,47,30,170,195,1147
429,Luka Šamanić\samanlu01,PF,20,SAS,1,0,12,0,4,.000,0,2,.000,0,2,.000,.000,0,0,,0,2,2,3,0,0,0,0,0
430,JaKarr Sampson\sampsja02,SF,26,IND,26,10,340,48,81,.593,2,13,.154,46,68,.676,.605,11,20,.550,15,44,59,9,9,9,7,43,109
431,Dario Šarić\saricda01,PF,25,PHO,59,50,1469,221,476,.464,75,217,.346,146,259,.564,.543,85,101,.842,89,262,351,112,35,15,76,136,602
432,Tomáš Satoranský\satorto01,PG,28,CHI,65,64,1878,237,551,.430,64,199,.322,173,352,.491,.488,106,121,.876,76,178,254,354,80,7,130,135,644
433,Admiral Schofield\schofad01,SF,22,WAS,28,2,298,30,77,.390,14,48,.292,16,29,.552,.481,9,13,.692,6,30,36,14,8,3,7,43,83
434,Dennis Schröder\schrode01,PG,26,OKC,63,1,1952,442,945,.468,122,320,.381,320,625,.512,.532,193,230,.839,19,214,233,256,43,14,159,138,1199
435,Mike Scott\scottmi01,PF,31,PHI,63,10,1119,130,319,.408,73,204,.358,57,115,.496,.522,25,30,.833,58,167,225,48,19,5,24,85,358
436,Thabo Sefolosha\sefolth01,PF,35,HOU,41,0,436,37,91,.407,15,54,.278,22,37,.595,.489,3,8,.375,21,72,93,25,24,12,15,43,92
437,Collin Sexton\sextoco01,SG,21,CLE,65,65,2143,513,1086,.472,97,255,.380,416,831,.501,.517,226,267,.846,61,143,204,192,65,7,158,142,1349
438,Landry Shamet\shamela01,SG,22,LAC,48,27,1316,147,359,.409,105,273,.385,42,86,.488,.556,57,63,.905,6,87,93,87,19,9,38,130,456
439,Marial Shayok\shayoma01,SG,24,PHI,2,0,10,1,5,.200,1,3,.333,0,2,.000,.300,0,0,,0,3,3,1,0,0,1,0,3
440,Iman Shumpert\shumpim01,SG,29,BRK,13,0,241,21,64,.328,8,33,.242,13,31,.419,.391,4,7,.571,9,25,34,12,12,2,10,21,54
441,Pascal Siakam\siakapa01,PF,25,TOR,53,53,1882,459,1000,.459,115,320,.359,344,680,.506,.517,220,275,.800,57,342,399,191,53,49,132,151,1253
442,Chris Silva\silvach01,PF,23,MIA,41,0,307,43,69,.623,0,2,.000,43,67,.642,.623,34,49,.694,54,55,109,21,9,18,31,80,120
443,Ben Simmons\simmobe01,PG,23,PHI,54,54,1930,361,617,.585,2,6,.333,359,611,.588,.587,178,284,.627,108,315,423,442,115,32,192,173,902
444,Anfernee Simons\simonan01,SG,20,POR,65,4,1400,211,525,.402,74,219,.338,137,306,.448,.472,76,92,.826,25,122,147,95,26,10,61,131,572
445,Alen Smailagić\smailal01,PF,19,GSW,14,0,139,20,40,.500,3,13,.231,17,27,.630,.538,16,19,.842,10,17,27,13,3,4,11,14,59
446,Marcus Smart\smartma01,SG,25,BOS,54,39,1753,247,643,.384,131,374,.350,116,269,.431,.486,112,135,.830,41,167,208,258,87,27,93,143,737
447,Dennis Smith Jr.\smithde03,PG,22,NYK,34,3,537,72,211,.341,16,54,.296,56,157,.357,.379,27,53,.509,21,57,78,98,28,8,58,65,187
448,Ish Smith\smithis01,PG,31,WAS,61,19,1596,270,599,.451,56,152,.368,214,447,.479,.497,48,70,.686,28,165,193,292,52,24,80,86,644
449,J.R. Smith\smithjr01,SG,34,LAL,1,0,8,0,1,.000,0,0,,0,1,.000,.000,0,0,,0,0,0,0,0,0,0,1,0
450,Zhaire Smith\smithzh01,SG,20,PHI,7,0,32,3,11,.273,0,3,.000,3,8,.375,.273,2,4,.500,0,2,2,2,3,0,2,4,8
451,Tony Snell\snellto01,SF,28,DET,59,57,1641,170,382,.445,102,254,.402,68,128,.531,.579,32,32,1.000,9,102,111,127,32,15,31,101,474
452,Omari Spellman\spellom01,PF,22,GSW,49,3,886,127,295,.431,43,110,.391,84,185,.454,.503,73,92,.793,77,142,219,47,33,24,54,63,370
453,Max Strus\strusma01,SG,23,CHI,2,0,6,2,3,.667,0,1,.000,2,2,1.000,.667,1,1,1.000,1,0,1,0,0,0,0,1,5
454,Edmond Sumner\sumneed01,PG,24,IND,25,2,345,47,111,.423,10,38,.263,37,73,.507,.468,10,15,.667,10,27,37,39,15,8,19,35,114
455,Caleb Swanigan\swanica01,PF,22,TOT,27,1,288,28,47,.596,0,2,.000,28,45,.622,.596,9,17,.529,27,73,100,31,3,7,37,62,65
455,Caleb Swanigan\swanica01,PF,22,SAC,7,0,23,2,4,.500,0,0,,2,4,.500,.500,1,2,.500,2,5,7,2,1,2,6,8,5
455,Caleb Swanigan\swanica01,PF,22,POR,20,1,265,26,43,.605,0,2,.000,26,41,.634,.605,8,15,.533,25,68,93,29,2,5,31,54,60
456,Jayson Tatum\tatumja01,PF,21,BOS,60,60,2076,501,1131,.443,167,424,.394,334,707,.472,.517,226,281,.804,61,364,425,177,85,54,134,124,1395
457,Jeff Teague\teaguje01,PG,31,TOT,59,17,1464,213,489,.436,43,117,.368,170,372,.457,.480,172,197,.873,27,115,142,308,44,19,116,106,641
457,Jeff Teague\teaguje01,PG,31,MIN,34,13,945,145,324,.448,33,87,.379,112,237,.473,.498,125,144,.868,15,73,88,208,25,13,76,70,448
457,Jeff Teague\teaguje01,PG,31,ATL,25,4,519,68,165,.412,10,30,.333,58,135,.430,.442,47,53,.887,12,42,54,100,19,6,40,36,193
458,Garrett Temple\templga01,SG,33,BRK,56,31,1571,199,529,.376,113,348,.325,86,181,.475,.483,56,73,.767,28,165,193,142,44,26,60,95,567
459,Daniel Theis\theisda01,C,27,BOS,59,58,1414,221,395,.559,28,87,.322,193,308,.627,.595,82,108,.759,134,258,392,98,35,77,50,206,552
460,Isaiah Thomas\thomais02,PG,30,WAS,40,37,925,174,426,.408,78,189,.413,96,237,.405,.500,62,76,.816,11,57,68,146,13,6,77,77,488
461,Khyri Thomas\thomakh01,SG,23,DET,8,0,61,5,17,.294,5,14,.357,0,3,.000,.441,2,4,.500,1,0,1,3,3,0,3,9,17
462,Lance Thomas\thomala01,F,31,BRK,1,1,18,2,4,.500,1,2,.500,1,2,.500,.625,1,1,1.000,0,2,2,1,0,0,1,3,6
463,Matt Thomas\thomama02,SG,25,TOR,33,0,321,54,111,.486,35,75,.467,19,36,.528,.644,7,10,.700,7,41,48,17,8,0,12,31,150
464,Tristan Thompson\thomptr01,C,28,CLE,57,51,1721,288,562,.512,9,23,.391,279,539,.518,.520,99,161,.615,226,351,577,120,33,50,103,124,684
465,Matisse Thybulle\thybuma01,SG,22,PHI,57,13,1110,96,234,.410,50,142,.352,46,92,.500,.517,25,41,.610,35,51,86,70,80,40,45,120,267
466,Anthony Tolliver\tollian01,PF,34,TOT,48,9,747,55,158,.348,40,124,.323,15,34,.441,.475,19,27,.704,30,104,134,35,15,11,30,65,169
466,Anthony Tolliver\tollian01,PF,34,POR,33,9,554,43,117,.368,30,89,.337,13,28,.464,.496,13,19,.684,27,83,110,29,8,9,21,54,129
466,Anthony Tolliver\tollian01,PF,34,SAC,9,0,82,3,17,.176,2,15,.133,1,2,.500,.235,1,2,.500,2,9,11,3,4,1,4,6,9
466,Anthony Tolliver\tollian01,PF,34,MEM,6,0,111,9,24,.375,8,20,.400,1,4,.250,.542,5,6,.833,1,12,13,3,3,1,5,5,31
467,Juan Toscano-Anderson\toscaju01,SF,26,GSW,13,6,272,29,63,.460,8,23,.348,21,40,.525,.524,3,5,.600,9,43,52,26,13,5,16,30,69
468,Karl-Anthony Towns\townska01,C,24,MIN,35,35,1187,316,622,.508,114,277,.412,202,345,.586,.600,180,226,.796,95,283,378,153,33,42,110,117,926
469,Gary Trent Jr.\trentga02,SG,21,POR,54,8,1086,154,358,.430,82,206,.398,72,152,.474,.545,33,41,.805,20,69,89,52,39,14,19,73,423
470,Allonzo Trier\trieral01,PG,24,NYK,24,1,291,51,106,.481,19,53,.358,32,53,.604,.571,34,43,.791,6,23,29,28,3,4,22,29,155
471,P.J. Tucker\tuckepj01,PF,34,HOU,65,65,2242,164,377,.435,97,260,.373,67,117,.573,.564,38,46,.826,102,343,445,104,71,32,67,214,463
472,Rayjon Tucker\tuckera01,SG,22,UTA,14,0,78,8,19,.421,0,6,.000,8,13,.615,.421,3,5,.600,2,11,13,2,1,0,3,7,19
473,Evan Turner\turneev01,PG,31,ATL,19,0,251,25,67,.373,0,5,.000,25,62,.403,.373,12,14,.857,8,30,38,38,9,8,26,20,62
474,Myles Turner\turnemy01,C,23,IND,55,55,1628,233,517,.451,77,229,.336,156,288,.542,.525,108,144,.750,70,290,360,61,42,120,68,138,651
475,Jarrod Uthoff\uthofja01,SF,26,MEM,4,0,14,1,7,.143,0,4,.000,1,3,.333,.143,2,2,1.000,1,0,1,0,1,0,0,1,4
476,Jonas Valančiūnas\valanjo01,C,27,MEM,63,63,1645,389,661,.589,30,80,.375,359,581,.618,.611,130,176,.739,191,509,700,110,25,69,109,164,938
477,Denzel Valentine\valende01,SF,26,CHI,36,5,488,97,237,.409,46,137,.336,51,100,.510,.506,6,8,.750,9,65,74,43,26,6,26,51,246
478,Jarred Vanderbilt\vandeja01,SF-PF,20,TOT,11,0,46,5,8,.625,0,1,.000,5,7,.714,.625,2,2,1.000,3,6,9,2,3,1,7,6,12
478,Jarred Vanderbilt\vandeja01,SF,20,DEN,9,0,41,5,7,.714,0,0,,5,7,.714,.714,0,0,,3,5,8,2,3,1,7,6,10
478,Jarred Vanderbilt\vandeja01,PF,20,MIN,2,0,5,0,1,.000,0,1,.000,0,0,,.000,2,2,1.000,0,1,1,0,0,0,0,0,2
479,Fred VanVleet\vanvlfr01,PG,25,TOR,48,48,1719,287,701,.409,131,338,.388,156,363,.430,.503,140,166,.843,18,162,180,317,91,13,110,118,845
480,Gabe Vincent\vincega01,PG,23,MIA,6,0,42,4,19,.211,4,16,.250,0,3,.000,.316,0,0,,0,3,3,3,1,0,0,2,12
481,Noah Vonleh\vonleno01,C-PF,24,TOT,33,1,364,50,89,.562,3,15,.200,47,74,.635,.579,24,30,.800,37,86,123,27,11,6,21,38,127
481,Noah Vonleh\vonleno01,C,24,MIN,29,1,347,47,86,.547,2,14,.143,45,72,.625,.558,23,28,.821,34,82,116,26,11,6,19,36,119
481,Noah Vonleh\vonleno01,PF,24,DEN,4,0,17,3,3,1.000,1,1,1.000,2,2,1.000,1.167,1,2,.500,3,4,7,1,0,0,2,2,8
482,Nikola Vučević\vucevni01,C,29,ORL,55,55,1790,436,922,.473,83,253,.328,353,669,.528,.518,119,151,.788,130,473,603,207,46,47,79,123,1074
483,Dean Wade\wadede01,PF,23,CLE,12,0,71,9,13,.692,2,4,.500,7,9,.778,.769,0,1,.000,3,16,19,2,2,4,3,8,20
484,Moritz Wagner\wagnemo01,C,22,WAS,38,5,721,132,231,.571,23,67,.343,109,164,.665,.621,67,82,.817,52,143,195,49,22,17,57,137,354
485,Dion Waiters\waitedi01,SG,28,TOT,4,0,63,15,36,.417,9,23,.391,6,13,.462,.542,0,1,.000,0,14,14,5,0,3,3,7,39
485,Dion Waiters\waitedi01,SG,28,MIA,3,0,42,10,26,.385,8,17,.471,2,9,.222,.538,0,1,.000,0,11,11,3,0,2,3,5,28
485,Dion Waiters\waitedi01,SG,28,LAL,1,0,21,5,10,.500,1,6,.167,4,4,1.000,.550,0,0,,0,3,3,2,0,1,0,2,11
486,Kemba Walker\walkeke02,PG,29,BOS,51,51,1611,355,841,.422,168,444,.378,187,397,.471,.522,198,229,.865,33,172,205,249,47,26,108,78,1076
487,Lonnie Walker\walkelo01,SG,21,SAS,54,5,799,123,279,.441,30,73,.411,93,206,.451,.495,39,54,.722,20,98,118,50,28,13,33,70,315
488,Tyrone Wallace\wallaty01,SG,25,ATL,14,0,160,14,44,.318,1,15,.067,13,29,.448,.330,11,17,.647,3,19,22,13,7,1,10,19,40
489,Taurean Prince\princta02,SF,25,BRK,64,61,1857,278,739,.376,146,431,.339,132,308,.429,.475,71,89,.798,50,331,381,116,57,25,127,159,773
490,Derrick Walton\waltode01,PG,24,TOT,26,1,248,18,39,.462,10,24,.417,8,15,.533,.590,7,9,.778,2,14,16,27,7,0,5,21,53
490,Derrick Walton\waltode01,PG,24,LAC,23,1,222,17,36,.472,9,21,.429,8,15,.533,.597,7,9,.778,2,13,15,22,4,0,4,19,50
490,Derrick Walton\waltode01,PG,24,DET,3,0,26,1,3,.333,1,3,.333,0,0,,.500,0,0,,0,1,1,5,3,0,1,2,3
491,Brad Wanamaker\wanambr01,PG,30,BOS,64,1,1241,141,327,.431,33,92,.359,108,235,.460,.482,112,120,.933,20,110,130,159,54,12,71,124,427
492,T.J. Warren\warretj01,SF,26,IND,61,61,1984,460,869,.529,69,184,.375,391,685,.571,.569,151,186,.812,61,181,242,87,70,27,77,170,1140
493,P.J. Washington\washipj01,PF,21,CHO,58,57,1759,268,589,.455,86,230,.374,182,359,.507,.528,88,136,.647,58,258,316,123,51,44,93,158,710
494,Yuta Watanabe\watanyu01,SG,25,MEM,16,0,99,12,29,.414,3,8,.375,9,21,.429,.466,3,8,.375,6,11,17,4,5,1,2,9,30
495,Tremont Waters\watertr01,PG,22,BOS,10,0,89,12,35,.343,3,17,.176,9,18,.500,.386,6,6,1.000,0,9,9,12,5,2,10,11,33
496,Paul Watson\watsopa01,SF-SG,25,TOT,5,0,25,0,8,.000,0,4,.000,0,4,.000,.000,1,2,.500,0,4,4,5,1,1,0,1,1
496,Paul Watson\watsopa01,SG,25,ATL,2,0,17,0,7,.000,0,3,.000,0,4,.000,.000,0,0,,0,2,2,3,1,0,0,1,0
496,Paul Watson\watsopa01,SF,25,TOR,3,0,8,0,1,.000,0,1,.000,0,0,,.000,1,2,.500,0,2,2,2,0,1,0,0,1
497,Quinndary Weatherspoon\weathqu01,SG,23,SAS,4,0,25,2,8,.250,0,2,.000,2,6,.333,.250,0,0,,0,2,2,3,1,0,1,1,4
498,Russell Westbrook\westbru01,PG,31,HOU,54,54,1948,581,1229,.473,52,204,.255,529,1025,.516,.494,273,354,.771,99,338,437,378,90,18,242,192,1487
499,Coby White\whiteco01,SG,19,CHI,65,1,1674,312,792,.394,133,376,.354,179,416,.430,.478,102,129,.791,28,202,230,175,49,6,109,117,859
500,Derrick White\whitede01,SG,25,SAS,62,14,1502,221,479,.461,61,169,.361,160,310,.516,.525,156,181,.862,32,169,201,211,40,56,80,136,659
501,Hassan Whiteside\whiteha01,C,30,POR,62,61,1928,421,681,.618,4,7,.571,417,674,.619,.621,154,226,.681,246,627,873,74,24,189,117,183,1000
502,Andrew Wiggins\wiggian01,SF-SG,24,TOT,54,54,1858,437,978,.447,111,334,.332,326,644,.506,.504,190,268,.709,66,208,274,198,45,53,132,127,1175
502,Andrew Wiggins\wiggian01,SF,24,MIN,42,42,1455,351,790,.444,91,275,.331,260,515,.505,.502,149,207,.720,48,171,219,155,29,36,107,101,942
502,Andrew Wiggins\wiggian01,SG,24,GSW,12,12,403,86,188,.457,20,59,.339,66,129,.512,.511,41,61,.672,18,37,55,43,16,17,25,26,233
503,Grant Williams\willigr01,PF,21,BOS,63,5,974,80,192,.417,21,85,.247,59,107,.551,.471,37,51,.725,58,107,165,62,29,33,46,150,218
504,Johnathan Williams\willijo04,C,24,WAS,12,5,147,16,25,.640,0,2,.000,16,23,.696,.640,4,7,.571,16,29,45,6,1,7,4,13,36
505,Kenrich Williams\willike04,PF,25,NOP,35,18,779,49,143,.343,25,96,.260,24,47,.511,.430,9,24,.375,49,129,178,53,25,21,21,81,132
506,Lou Williams\willilo02,SG,33,LAC,60,8,1757,367,883,.416,107,295,.363,260,588,.442,.476,278,322,.863,28,158,186,344,40,10,172,77,1119
507,Marvin Williams\willima02,PF,33,TOT,52,1,1011,110,249,.442,52,144,.361,58,105,.552,.546,47,54,.870,20,128,148,56,35,26,28,94,319
507,Marvin Williams\willima02,PF,33,CHO,41,1,808,94,210,.448,44,117,.376,50,93,.538,.552,43,50,.860,15,94,109,41,26,22,25,71,275
507,Marvin Williams\willima02,PF,33,MIL,11,0,203,16,39,.410,8,27,.296,8,12,.667,.513,4,4,1.000,5,34,39,15,9,4,3,23,44
508,Robert Williams\williro04,C,22,BOS,23,1,323,42,62,.677,0,0,,42,62,.677,.677,14,25,.560,34,74,108,22,20,28,20,40,98
509,Nigel Williams-Goss\willini01,PG,25,UTA,9,0,28,1,7,.143,0,2,.000,1,5,.200,.143,2,2,1.000,2,3,5,5,1,1,2,2,4
510,Zion Williamson\willizi01,PF,19,NOP,20,20,580,178,300,.593,6,13,.462,172,287,.599,.603,99,153,.647,55,74,129,42,16,9,53,35,461
511,D.J. Wilson\wilsodj01,PF,23,MIL,32,0,280,40,101,.396,14,55,.255,26,46,.565,.465,6,9,.667,10,58,68,22,2,5,15,26,100
512,Justise Winslow\winslju01,SF,23,MIA,11,5,352,50,129,.388,6,27,.222,44,102,.431,.411,18,27,.667,16,57,73,44,7,5,24,38,124
513,Christian Wood\woodch01,PF,24,DET,62,12,1325,288,508,.567,54,140,.386,234,368,.636,.620,180,242,.744,104,286,390,60,34,54,84,98,810
514,Delon Wright\wrighde01,SG,27,DAL,66,5,1427,181,385,.470,46,119,.387,135,266,.508,.530,71,90,.789,67,194,261,221,76,21,69,85,479
515,Justin Wright-Foreman\wrighju02,PG,22,UTA,1,0,2,0,0,,0,0,,0,0,,,0,0,,0,0,0,0,0,0,0,0,0
516,Thaddeus Young\youngth01,PF,31,CHI,64,16,1591,269,601,.448,79,222,.356,190,379,.501,.513,42,72,.583,94,221,315,117,92,23,102,134,659
517,Trae Young\youngtr01,PG,21,ATL,60,60,2120,546,1249,.437,205,568,.361,341,681,.501,.519,481,559,.860,32,223,255,560,65,8,289,104,1778
518,Cody Zeller\zelleco01,C,27,CHO,58,39,1341,251,479,.524,18,75,.240,233,404,.577,.543,122,179,.682,160,251,411,88,40,25,75,140,642
519,Ante Žižić\zizican01,C,23,CLE,22,0,221,41,72,.569,0,0,,41,72,.569,.569,14,19,.737,18,48,66,6,7,5,10,27,96
520,Ivica Zubac\zubaciv01,C,22,LAC,65,63,1172,203,339,.599,0,2,.000,203,337,.602,.599,107,141,.759,167,297,464,70,14,61,55,150,513